index,year,state,state_po,totalvotes,D_name,R_name,D_votes,R_votes,winner_votes,loser_votes,votes_to_flip,party_win,electoral_votes,total_electoral_votes,D_electoral,R_electoral,overall_winner,winner_state
0,1976,ALABAMA,AL,1163240,"CARTER, JIMMY","FORD, GERALD",659170,504070,659170,504070,77551,D,9,538,297,241,D,True
1,1976,ALASKA,AK,115613,"CARTER, JIMMY","FORD, GERALD",44058,71555,71555,44058,13749,R,3,538,297,241,D,False
2,1976,ARIZONA,AZ,714244,"CARTER, JIMMY","FORD, GERALD",295602,418642,418642,295602,61521,R,6,538,297,241,D,False
3,1976,ARKANSAS,AR,766507,"CARTER, JIMMY","FORD, GERALD",498604,267903,498604,267903,115351,D,6,538,297,241,D,True
4,1976,CALIFORNIA,CA,7624528,"CARTER, JIMMY","FORD, GERALD",3742284,3882244,3882244,3742284,69981,R,45,538,297,241,D,False
5,1976,COLORADO,CO,1045079,"CARTER, JIMMY","FORD, GERALD",460801,584278,584278,460801,61739,R,7,538,297,241,D,False
6,1976,CONNECTICUT,CT,1367156,"CARTER, JIMMY","FORD, GERALD",647895,719261,719261,647895,35684,R,8,538,297,241,D,False
7,1976,DELAWARE,DE,232241,"CARTER, JIMMY","FORD, GERALD",122461,109780,122461,109780,6341,D,3,538,297,241,D,True
8,1976,D.C.,DC,165691,"CARTER, JIMMY","FORD, GERALD",137818,27873,137818,27873,54973,D,3,538,297,241,D,True
9,1976,FLORIDA,FL,3105531,"CARTER, JIMMY","FORD, GERALD",1636000,1469531,1636000,1469531,83235,D,17,538,297,241,D,True
10,1976,GEORGIA,GA,1463152,"CARTER, JIMMY","FORD, GERALD",979409,483743,979409,483743,247834,D,12,538,297,241,D,True
11,1976,HAWAII,HI,287378,"CARTER, JIMMY","FORD, GERALD",147375,140003,147375,140003,3687,D,4,538,297,241,D,True
12,1976,IDAHO,ID,330700,"CARTER, JIMMY","FORD, GERALD",126549,204151,204151,126549,38802,R,4,538,297,241,D,False
13,1976,ILLINOIS,IL,4635564,"CARTER, JIMMY","FORD, GERALD",2271295,2364269,2364269,2271295,46488,R,26,538,297,241,D,False
14,1976,INDIANA,IN,2198672,"CARTER, JIMMY","FORD, GERALD",1014714,1183958,1183958,1014714,84623,R,13,538,297,241,D,False
15,1976,IOWA,IA,1252795,"CARTER, JIMMY","FORD, GERALD",619931,632864,632864,619931,6467,R,8,538,297,241,D,False
16,1976,KANSAS,KS,933173,"CARTER, JIMMY","FORD, GERALD",430421,502752,502752,430421,36166,R,7,538,297,241,D,False
17,1976,KENTUCKY,KY,1147569,"CARTER, JIMMY","FORD, GERALD",615717,531852,615717,531852,41933,D,9,538,297,241,D,True
18,1976,LOUISIANA,LA,1248811,"CARTER, JIMMY","FORD, GERALD",661365,587446,661365,587446,36960,D,10,538,297,241,D,True
19,1976,MAINE,ME,468599,"CARTER, JIMMY","FORD, GERALD",232279,236320,236320,232279,2021,R,4,538,297,241,D,False
20,1976,MARYLAND,MD,1432273,"CARTER, JIMMY","FORD, GERALD",759612,672661,759612,672661,43476,D,10,538,297,241,D,True
21,1976,MASSACHUSETTS,MA,2459751,"CARTER, JIMMY","FORD, GERALD",1429475,1030276,1429475,1030276,199600,D,14,538,297,241,D,True
22,1976,MICHIGAN,MI,3590456,"CARTER, JIMMY","FORD, GERALD",1696714,1893742,1893742,1696714,98515,R,21,538,297,241,D,False
23,1976,MINNESOTA,MN,1889835,"CARTER, JIMMY","FORD, GERALD",1070440,819395,1070440,819395,125523,D,10,538,297,241,D,True
24,1976,MISSISSIPPI,MS,748175,"CARTER, JIMMY","FORD, GERALD",381329,366846,381329,366846,7242,D,7,538,297,241,D,True
25,1976,MISSOURI,MO,1925830,"CARTER, JIMMY","FORD, GERALD",998387,927443,998387,927443,35473,D,12,538,297,241,D,True
26,1976,MONTANA,MT,322962,"CARTER, JIMMY","FORD, GERALD",149259,173703,173703,149259,12223,R,4,538,297,241,D,False
27,1976,NEBRASKA,NE,592512,"CARTER, JIMMY","FORD, GERALD",233293,359219,359219,233293,62964,R,5,538,297,241,D,False
28,1976,NEVADA,NV,193752,"CARTER, JIMMY","FORD, GERALD",92479,101273,101273,92479,4398,R,3,538,297,241,D,False
29,1976,NEW HAMPSHIRE,NH,333580,"CARTER, JIMMY","FORD, GERALD",147645,185935,185935,147645,19146,R,4,538,297,241,D,False
30,1976,NEW JERSEY,NJ,2954341,"CARTER, JIMMY","FORD, GERALD",1444653,1509688,1509688,1444653,32518,R,17,538,297,241,D,False
31,1976,NEW MEXICO,NM,412567,"CARTER, JIMMY","FORD, GERALD",201148,211419,211419,201148,5136,R,4,538,297,241,D,False
32,1976,NEW YORK,NY,6070078,"CARTER, JIMMY","FORD, GERALD",3244165,2825913,3244165,2825913,209127,D,41,538,297,241,D,True
33,1976,NORTH CAROLINA,NC,1669325,"CARTER, JIMMY","FORD, GERALD",927365,741960,927365,741960,92703,D,13,538,297,241,D,True
34,1976,NORTH DAKOTA,ND,289762,"CARTER, JIMMY","FORD, GERALD",136078,153684,153684,136078,8804,R,3,538,297,241,D,False
35,1976,OHIO,OH,4010585,"CARTER, JIMMY","FORD, GERALD",2009959,2000626,2009959,2000626,4667,D,25,538,297,241,D,True
36,1976,OKLAHOMA,OK,1078150,"CARTER, JIMMY","FORD, GERALD",532442,545708,545708,532442,6634,R,8,538,297,241,D,False
37,1976,OREGON,OR,982527,"CARTER, JIMMY","FORD, GERALD",490407,492120,492120,490407,857,R,6,538,297,241,D,False
38,1976,PENNSYLVANIA,PA,4534281,"CARTER, JIMMY","FORD, GERALD",2328677,2205604,2328677,2205604,61537,D,27,538,297,241,D,True
39,1976,RHODE ISLAND,RI,408885,"CARTER, JIMMY","FORD, GERALD",227636,181249,227636,181249,23194,D,4,538,297,241,D,True
40,1976,SOUTH CAROLINA,SC,796956,"CARTER, JIMMY","FORD, GERALD",450807,346149,450807,346149,52330,D,8,538,297,241,D,True
41,1976,SOUTH DAKOTA,SD,298573,"CARTER, JIMMY","FORD, GERALD",147068,151505,151505,147068,2219,R,4,538,297,241,D,False
42,1976,TENNESSEE,TN,1459848,"CARTER, JIMMY","FORD, GERALD",825879,633969,825879,633969,95956,D,10,538,297,241,D,True
43,1976,TEXAS,TX,4035619,"CARTER, JIMMY","FORD, GERALD",2082319,1953300,2082319,1953300,64510,D,26,538,297,241,D,True
44,1976,UTAH,UT,520018,"CARTER, JIMMY","FORD, GERALD",182110,337908,337908,182110,77900,R,4,538,297,241,D,False
45,1976,VERMONT,VT,178185,"CARTER, JIMMY","FORD, GERALD",77798,100387,100387,77798,11295,R,3,538,297,241,D,False
46,1976,VIRGINIA,VA,1650450,"CARTER, JIMMY","FORD, GERALD",813896,836554,836554,813896,11330,R,12,538,297,241,D,False
47,1976,WASHINGTON,WA,1495055,"CARTER, JIMMY","FORD, GERALD",717323,777732,777732,717323,30205,R,9,538,297,241,D,False
48,1976,WEST VIRGINIA,WV,750590,"CARTER, JIMMY","FORD, GERALD",435864,314726,435864,314726,60570,D,6,538,297,241,D,True
49,1976,WISCONSIN,WI,2045219,"CARTER, JIMMY","FORD, GERALD",1040232,1004987,1040232,1004987,17623,D,11,538,297,241,D,True
50,1976,WYOMING,WY,154956,"CARTER, JIMMY","FORD, GERALD",62239,92717,92717,62239,15240,R,3,538,297,241,D,False
51,1980,ALABAMA,AL,1290922,"CARTER, JIMMY","REAGAN, RONALD",636730,654192,654192,636730,8732,R,9,538,90,448,R,True
52,1980,ALASKA,AK,127954,"CARTER, JIMMY","REAGAN, RONALD",41842,86112,86112,41842,22136,R,3,538,90,448,R,True
53,1980,ARIZONA,AZ,776531,"CARTER, JIMMY","REAGAN, RONALD",246843,529688,529688,246843,141423,R,6,538,90,448,R,True
54,1980,ARKANSAS,AR,801205,"CARTER, JIMMY","REAGAN, RONALD",398041,403164,403164,398041,2562,R,6,538,90,448,R,True
55,1980,CALIFORNIA,CA,7605937,"CARTER, JIMMY","REAGAN, RONALD",3082943,4522994,4522994,3082943,720026,R,45,538,90,448,R,True
56,1980,COLORADO,CO,1020273,"CARTER, JIMMY","REAGAN, RONALD",368009,652264,652264,368009,142128,R,7,538,90,448,R,True
57,1980,CONNECTICUT,CT,1218942,"CARTER, JIMMY","REAGAN, RONALD",541732,677210,677210,541732,67740,R,8,538,90,448,R,True
58,1980,DELAWARE,DE,217006,"CARTER, JIMMY","REAGAN, RONALD",105754,111252,111252,105754,2750,R,3,538,90,448,R,True
59,1980,D.C.,DC,153544,"CARTER, JIMMY","REAGAN, RONALD",130231,23313,130231,23313,53460,D,3,538,90,448,R,False
60,1980,FLORIDA,FL,3466426,"CARTER, JIMMY","REAGAN, RONALD",1419475,2046951,2046951,1419475,313739,R,17,538,90,448,R,True
61,1980,GEORGIA,GA,1545123,"CARTER, JIMMY","REAGAN, RONALD",890955,654168,890955,654168,118394,D,12,538,90,448,R,False
62,1980,HAWAII,HI,265991,"CARTER, JIMMY","REAGAN, RONALD",135879,130112,135879,130112,2884,D,4,538,90,448,R,False
63,1980,IDAHO,ID,400891,"CARTER, JIMMY","REAGAN, RONALD",110192,290699,290699,110192,90254,R,4,538,90,448,R,True
64,1980,ILLINOIS,IL,4339462,"CARTER, JIMMY","REAGAN, RONALD",1981413,2358049,2358049,1981413,188319,R,26,538,90,448,R,True
65,1980,INDIANA,IN,2099853,"CARTER, JIMMY","REAGAN, RONALD",844197,1255656,1255656,844197,205730,R,13,538,90,448,R,True
66,1980,IOWA,IA,1184698,"CARTER, JIMMY","REAGAN, RONALD",508672,676026,676026,508672,83678,R,8,538,90,448,R,True
67,1980,KANSAS,KS,892962,"CARTER, JIMMY","REAGAN, RONALD",326150,566812,566812,326150,120332,R,7,538,90,448,R,True
68,1980,KENTUCKY,KY,1252691,"CARTER, JIMMY","REAGAN, RONALD",617417,635274,635274,617417,8929,R,9,538,90,448,R,True
69,1980,LOUISIANA,LA,1501306,"CARTER, JIMMY","REAGAN, RONALD",708453,792853,792853,708453,42201,R,10,538,90,448,R,True
70,1980,MAINE,ME,459496,"CARTER, JIMMY","REAGAN, RONALD",220974,238522,238522,220974,8775,R,4,538,90,448,R,True
71,1980,MARYLAND,MD,1406767,"CARTER, JIMMY","REAGAN, RONALD",726161,680606,726161,680606,22778,D,10,538,90,448,R,False
72,1980,MASSACHUSETTS,MA,2111433,"CARTER, JIMMY","REAGAN, RONALD",1053802,1057631,1057631,1053802,1915,R,14,538,90,448,R,True
73,1980,MICHIGAN,MI,3576757,"CARTER, JIMMY","REAGAN, RONALD",1661532,1915225,1915225,1661532,126847,R,21,538,90,448,R,True
74,1980,MINNESOTA,MN,1827441,"CARTER, JIMMY","REAGAN, RONALD",954173,873268,954173,873268,40453,D,10,538,90,448,R,False
75,1980,MISSISSIPPI,MS,870370,"CARTER, JIMMY","REAGAN, RONALD",429281,441089,441089,429281,5905,R,7,538,90,448,R,True
76,1980,MISSOURI,MO,2005363,"CARTER, JIMMY","REAGAN, RONALD",931182,1074181,1074181,931182,71500,R,12,538,90,448,R,True
77,1980,MONTANA,MT,324846,"CARTER, JIMMY","REAGAN, RONALD",118032,206814,206814,118032,44392,R,4,538,90,448,R,True
78,1980,NEBRASKA,NE,585638,"CARTER, JIMMY","REAGAN, RONALD",166424,419214,419214,166424,126396,R,5,538,90,448,R,True
79,1980,NEVADA,NV,221683,"CARTER, JIMMY","REAGAN, RONALD",66666,155017,155017,66666,44176,R,3,538,90,448,R,True
80,1980,NEW HAMPSHIRE,NH,330569,"CARTER, JIMMY","REAGAN, RONALD",108864,221705,221705,108864,56421,R,4,538,90,448,R,True
81,1980,NEW JERSEY,NJ,2693921,"CARTER, JIMMY","REAGAN, RONALD",1147364,1546557,1546557,1147364,199597,R,17,538,90,448,R,True
82,1980,NEW MEXICO,NM,418605,"CARTER, JIMMY","REAGAN, RONALD",167826,250779,250779,167826,41477,R,4,538,90,448,R,True
83,1980,NEW YORK,NY,5366072,"CARTER, JIMMY","REAGAN, RONALD",2728372,2637700,2728372,2637700,45337,D,41,538,90,448,R,False
84,1980,NORTH CAROLINA,NC,1790653,"CARTER, JIMMY","REAGAN, RONALD",875635,915018,915018,875635,19692,R,13,538,90,448,R,True
85,1980,NORTH DAKOTA,ND,272884,"CARTER, JIMMY","REAGAN, RONALD",79189,193695,193695,79189,57254,R,3,538,90,448,R,True
86,1980,OHIO,OH,3958959,"CARTER, JIMMY","REAGAN, RONALD",1752414,2206545,2206545,1752414,227066,R,25,538,90,448,R,True
87,1980,OKLAHOMA,OK,1097596,"CARTER, JIMMY","REAGAN, RONALD",402026,695570,695570,402026,146773,R,8,538,90,448,R,True
88,1980,OREGON,OR,1027934,"CARTER, JIMMY","REAGAN, RONALD",456890,571044,571044,456890,57078,R,6,538,90,448,R,True
89,1980,PENNSYLVANIA,PA,4199412,"CARTER, JIMMY","REAGAN, RONALD",1937540,2261872,2261872,1937540,162167,R,27,538,90,448,R,True
90,1980,RHODE ISLAND,RI,353135,"CARTER, JIMMY","REAGAN, RONALD",198342,154793,198342,154793,21775,D,4,538,90,448,R,False
91,1980,SOUTH CAROLINA,SC,867497,"CARTER, JIMMY","REAGAN, RONALD",428220,439277,439277,428220,5529,R,8,538,90,448,R,True
92,1980,SOUTH DAKOTA,SD,302198,"CARTER, JIMMY","REAGAN, RONALD",103855,198343,198343,103855,47245,R,4,538,90,448,R,True
93,1980,TENNESSEE,TN,1570812,"CARTER, JIMMY","REAGAN, RONALD",783051,787761,787761,783051,2356,R,10,538,90,448,R,True
94,1980,TEXAS,TX,4391852,"CARTER, JIMMY","REAGAN, RONALD",1881147,2510705,2510705,1881147,314780,R,26,538,90,448,R,True
95,1980,UTAH,UT,563953,"CARTER, JIMMY","REAGAN, RONALD",124266,439687,439687,124266,157711,R,4,538,90,448,R,True
96,1980,VERMONT,VT,176580,"CARTER, JIMMY","REAGAN, RONALD",81952,94628,94628,81952,6339,R,3,538,90,448,R,True
97,1980,VIRGINIA,VA,1741783,"CARTER, JIMMY","REAGAN, RONALD",752174,989609,989609,752174,118718,R,12,538,90,448,R,True
98,1980,WASHINGTON,WA,1515437,"CARTER, JIMMY","REAGAN, RONALD",650193,865244,865244,650193,107526,R,9,538,90,448,R,True
99,1980,WEST VIRGINIA,WV,701668,"CARTER, JIMMY","REAGAN, RONALD",367462,334206,367462,334206,16629,D,6,538,90,448,R,False
100,1980,WISCONSIN,WI,2070429,"CARTER, JIMMY","REAGAN, RONALD",981584,1088845,1088845,981584,53631,R,11,538,90,448,R,True
101,1980,WYOMING,WY,160127,"CARTER, JIMMY","REAGAN, RONALD",49427,110700,110700,49427,30637,R,3,538,90,448,R,True
102,1984,ALABAMA,AL,1424748,"MONDALE, WALTER","REAGAN, RONALD",551899,872849,872849,551899,160476,R,9,538,13,525,R,True
103,1984,ALASKA,AK,200384,"MONDALE, WALTER","REAGAN, RONALD",62007,138377,138377,62007,38186,R,3,538,13,525,R,True
104,1984,ARIZONA,AZ,1015270,"MONDALE, WALTER","REAGAN, RONALD",333854,681416,681416,333854,173782,R,7,538,13,525,R,True
105,1984,ARKANSAS,AR,873420,"MONDALE, WALTER","REAGAN, RONALD",338646,534774,534774,338646,98065,R,6,538,13,525,R,True
106,1984,CALIFORNIA,CA,9389528,"MONDALE, WALTER","REAGAN, RONALD",3922519,5467009,5467009,3922519,772246,R,47,538,13,525,R,True
107,1984,COLORADO,CO,1276792,"MONDALE, WALTER","REAGAN, RONALD",454975,821817,821817,454975,183422,R,8,538,13,525,R,True
108,1984,CONNECTICUT,CT,1460474,"MONDALE, WALTER","REAGAN, RONALD",569597,890877,890877,569597,160641,R,8,538,13,525,R,True
109,1984,DELAWARE,DE,253846,"MONDALE, WALTER","REAGAN, RONALD",101656,152190,152190,101656,25268,R,3,538,13,525,R,True
110,1984,D.C.,DC,209417,"MONDALE, WALTER","REAGAN, RONALD",180408,29009,180408,29009,75700,D,3,538,13,525,R,False
111,1984,FLORIDA,FL,4179166,"MONDALE, WALTER","REAGAN, RONALD",1448816,2730350,2730350,1448816,640768,R,21,538,13,525,R,True
112,1984,GEORGIA,GA,1775350,"MONDALE, WALTER","REAGAN, RONALD",706628,1068722,1068722,706628,181048,R,12,538,13,525,R,True
113,1984,HAWAII,HI,332204,"MONDALE, WALTER","REAGAN, RONALD",147154,185050,185050,147154,18949,R,4,538,13,525,R,True
114,1984,IDAHO,ID,406033,"MONDALE, WALTER","REAGAN, RONALD",108510,297523,297523,108510,94507,R,4,538,13,525,R,True
115,1984,ILLINOIS,IL,4793602,"MONDALE, WALTER","REAGAN, RONALD",2086499,2707103,2707103,2086499,310303,R,24,538,13,525,R,True
116,1984,INDIANA,IN,2218711,"MONDALE, WALTER","REAGAN, RONALD",841481,1377230,1377230,841481,267875,R,12,538,13,525,R,True
117,1984,IOWA,IA,1308708,"MONDALE, WALTER","REAGAN, RONALD",605620,703088,703088,605620,48735,R,8,538,13,525,R,True
118,1984,KANSAS,KS,1010445,"MONDALE, WALTER","REAGAN, RONALD",333149,677296,677296,333149,172074,R,7,538,13,525,R,True
119,1984,KENTUCKY,KY,1361241,"MONDALE, WALTER","REAGAN, RONALD",539539,821702,821702,539539,141082,R,9,538,13,525,R,True
120,1984,LOUISIANA,LA,1688885,"MONDALE, WALTER","REAGAN, RONALD",651586,1037299,1037299,651586,192857,R,10,538,13,525,R,True
121,1984,MAINE,ME,551015,"MONDALE, WALTER","REAGAN, RONALD",214515,336500,336500,214515,60993,R,4,538,13,525,R,True
122,1984,MARYLAND,MD,1667853,"MONDALE, WALTER","REAGAN, RONALD",787935,879918,879918,787935,45992,R,10,538,13,525,R,True
123,1984,MASSACHUSETTS,MA,2550542,"MONDALE, WALTER","REAGAN, RONALD",1239606,1310936,1310936,1239606,35666,R,13,538,13,525,R,True
124,1984,MICHIGAN,MI,3781209,"MONDALE, WALTER","REAGAN, RONALD",1529638,2251571,2251571,1529638,360967,R,20,538,13,525,R,True
125,1984,MINNESOTA,MN,2068967,"MONDALE, WALTER","REAGAN, RONALD",1036364,1032603,1036364,1032603,1881,D,10,538,13,525,R,False
126,1984,MISSISSIPPI,MS,934569,"MONDALE, WALTER","REAGAN, RONALD",352192,582377,582377,352192,115093,R,7,538,13,525,R,True
127,1984,MISSOURI,MO,2122771,"MONDALE, WALTER","REAGAN, RONALD",848583,1274188,1274188,848583,212803,R,11,538,13,525,R,True
128,1984,MONTANA,MT,379192,"MONDALE, WALTER","REAGAN, RONALD",146742,232450,232450,146742,42855,R,4,538,13,525,R,True
129,1984,NEBRASKA,NE,647920,"MONDALE, WALTER","REAGAN, RONALD",187866,460054,460054,187866,136095,R,5,538,13,525,R,True
130,1984,NEVADA,NV,280425,"MONDALE, WALTER","REAGAN, RONALD",91655,188770,188770,91655,48558,R,4,538,13,525,R,True
131,1984,NEW HAMPSHIRE,NH,387397,"MONDALE, WALTER","REAGAN, RONALD",120347,267050,267050,120347,73352,R,4,538,13,525,R,True
132,1984,NEW JERSEY,NJ,3194953,"MONDALE, WALTER","REAGAN, RONALD",1261323,1933630,1933630,1261323,336154,R,16,538,13,525,R,True
133,1984,NEW MEXICO,NM,508870,"MONDALE, WALTER","REAGAN, RONALD",201769,307101,307101,201769,52667,R,5,538,13,525,R,True
134,1984,NEW YORK,NY,6377804,"MONDALE, WALTER","REAGAN, RONALD",3001285,3376519,3376519,3001285,187618,R,36,538,13,525,R,True
135,1984,NORTH CAROLINA,NC,2170768,"MONDALE, WALTER","REAGAN, RONALD",824287,1346481,1346481,824287,261098,R,13,538,13,525,R,True
136,1984,NORTH DAKOTA,ND,304765,"MONDALE, WALTER","REAGAN, RONALD",104429,200336,200336,104429,47954,R,3,538,13,525,R,True
137,1984,OHIO,OH,4503999,"MONDALE, WALTER","REAGAN, RONALD",1825440,2678559,2678559,1825440,426560,R,23,538,13,525,R,True
138,1984,OKLAHOMA,OK,1246610,"MONDALE, WALTER","REAGAN, RONALD",385080,861530,861530,385080,238226,R,8,538,13,525,R,True
139,1984,OREGON,OR,1222179,"MONDALE, WALTER","REAGAN, RONALD",536479,685700,685700,536479,74611,R,7,538,13,525,R,True
140,1984,PENNSYLVANIA,PA,4812454,"MONDALE, WALTER","REAGAN, RONALD",2228131,2584323,2584323,2228131,178097,R,25,538,13,525,R,True
141,1984,RHODE ISLAND,RI,409186,"MONDALE, WALTER","REAGAN, RONALD",197106,212080,212080,197106,7488,R,4,538,13,525,R,True
142,1984,SOUTH CAROLINA,SC,959998,"MONDALE, WALTER","REAGAN, RONALD",344459,615539,615539,344459,135541,R,8,538,13,525,R,True
143,1984,SOUTH DAKOTA,SD,316380,"MONDALE, WALTER","REAGAN, RONALD",116113,200267,200267,116113,42078,R,3,538,13,525,R,True
144,1984,TENNESSEE,TN,1701926,"MONDALE, WALTER","REAGAN, RONALD",711714,990212,990212,711714,139250,R,11,538,13,525,R,True
145,1984,TEXAS,TX,5382704,"MONDALE, WALTER","REAGAN, RONALD",1949276,3433428,3433428,1949276,742077,R,29,538,13,525,R,True
146,1984,UTAH,UT,624474,"MONDALE, WALTER","REAGAN, RONALD",155369,469105,469105,155369,156869,R,5,538,13,525,R,True
147,1984,VERMONT,VT,231595,"MONDALE, WALTER","REAGAN, RONALD",95730,135865,135865,95730,20068,R,3,538,13,525,R,True
148,1984,VIRGINIA,VA,2133328,"MONDALE, WALTER","REAGAN, RONALD",796250,1337078,1337078,796250,270415,R,12,538,13,525,R,True
149,1984,WASHINGTON,WA,1850022,"MONDALE, WALTER","REAGAN, RONALD",798352,1051670,1051670,798352,126660,R,10,538,13,525,R,True
150,1984,WEST VIRGINIA,WV,733608,"MONDALE, WALTER","REAGAN, RONALD",328125,405483,405483,328125,38680,R,6,538,13,525,R,True
151,1984,WISCONSIN,WI,2194324,"MONDALE, WALTER","REAGAN, RONALD",995740,1198584,1198584,995740,101423,R,11,538,13,525,R,True
152,1984,WYOMING,WY,186611,"MONDALE, WALTER","REAGAN, RONALD",53370,133241,133241,53370,39936,R,3,538,13,525,R,True
153,1988,ALABAMA,AL,1365082,"DUKAKIS, MICHAEL","BUSH, GEORGE H.W.",549506,815576,815576,549506,133036,R,9,538,112,426,R,True
154,1988,ALASKA,AK,191835,"DUKAKIS, MICHAEL","BUSH, GEORGE H.W.",72584,119251,119251,72584,23334,R,3,538,112,426,R,True
155,1988,ARIZONA,AZ,1156570,"DUKAKIS, MICHAEL","BUSH, GEORGE H.W.",454029,702541,702541,454029,124257,R,7,538,112,426,R,True
156,1988,ARKANSAS,AR,815815,"DUKAKIS, MICHAEL","BUSH, GEORGE H.W.",349237,466578,466578,349237,58671,R,6,538,112,426,R,True
157,1988,CALIFORNIA,CA,9757150,"DUKAKIS, MICHAEL","BUSH, GEORGE H.W.",4702233,5054917,5054917,4702233,176343,R,47,538,112,426,R,True
158,1988,COLORADO,CO,1349630,"DUKAKIS, MICHAEL","BUSH, GEORGE H.W.",621453,728177,728177,621453,53363,R,8,538,112,426,R,True
159,1988,CONNECTICUT,CT,1426825,"DUKAKIS, MICHAEL","BUSH, GEORGE H.W.",676584,750241,750241,676584,36829,R,8,538,112,426,R,True
160,1988,DELAWARE,DE,248286,"DUKAKIS, MICHAEL","BUSH, GEORGE H.W.",108647,139639,139639,108647,15497,R,3,538,112,426,R,True
161,1988,D.C.,DC,186997,"DUKAKIS, MICHAEL","BUSH, GEORGE H.W.",159407,27590,159407,27590,65909,D,3,538,112,426,R,False
162,1988,FLORIDA,FL,4275586,"DUKAKIS, MICHAEL","BUSH, GEORGE H.W.",1656701,2618885,2618885,1656701,481093,R,21,538,112,426,R,True
163,1988,GEORGIA,GA,1796123,"DUKAKIS, MICHAEL","BUSH, GEORGE H.W.",714792,1081331,1081331,714792,183270,R,12,538,112,426,R,True
164,1988,HAWAII,HI,350989,"DUKAKIS, MICHAEL","BUSH, GEORGE H.W.",192364,158625,192364,158625,16870,D,4,538,112,426,R,False
165,1988,IDAHO,ID,401153,"DUKAKIS, MICHAEL","BUSH, GEORGE H.W.",147272,253881,253881,147272,53305,R,4,538,112,426,R,True
166,1988,ILLINOIS,IL,4526879,"DUKAKIS, MICHAEL","BUSH, GEORGE H.W.",2215940,2310939,2310939,2215940,47500,R,24,538,112,426,R,True
167,1988,INDIANA,IN,2158406,"DUKAKIS, MICHAEL","BUSH, GEORGE H.W.",860643,1297763,1297763,860643,218561,R,12,538,112,426,R,True
168,1988,IOWA,IA,1215912,"DUKAKIS, MICHAEL","BUSH, GEORGE H.W.",670557,545355,670557,545355,62602,D,8,538,112,426,R,False
169,1988,KANSAS,KS,976685,"DUKAKIS, MICHAEL","BUSH, GEORGE H.W.",422636,554049,554049,422636,65707,R,7,538,112,426,R,True
170,1988,KENTUCKY,KY,1314649,"DUKAKIS, MICHAEL","BUSH, GEORGE H.W.",580368,734281,734281,580368,76957,R,9,538,112,426,R,True
171,1988,LOUISIANA,LA,1601162,"DUKAKIS, MICHAEL","BUSH, GEORGE H.W.",717460,883702,883702,717460,83122,R,10,538,112,426,R,True
172,1988,MAINE,ME,550700,"DUKAKIS, MICHAEL","BUSH, GEORGE H.W.",243569,307131,307131,243569,31782,R,4,538,112,426,R,True
173,1988,MARYLAND,MD,1702471,"DUKAKIS, MICHAEL","BUSH, GEORGE H.W.",826304,876167,876167,826304,24932,R,10,538,112,426,R,True
174,1988,MASSACHUSETTS,MA,2596050,"DUKAKIS, MICHAEL","BUSH, GEORGE H.W.",1401415,1194635,1401415,1194635,103391,D,13,538,112,426,R,False
175,1988,MICHIGAN,MI,3641269,"DUKAKIS, MICHAEL","BUSH, GEORGE H.W.",1675783,1965486,1965486,1675783,144852,R,20,538,112,426,R,True
176,1988,MINNESOTA,MN,2071808,"DUKAKIS, MICHAEL","BUSH, GEORGE H.W.",1109471,962337,1109471,962337,73568,D,10,538,112,426,R,False
177,1988,MISSISSIPPI,MS,921811,"DUKAKIS, MICHAEL","BUSH, GEORGE H.W.",363921,557890,557890,363921,96985,R,7,538,112,426,R,True
178,1988,MISSOURI,MO,2086572,"DUKAKIS, MICHAEL","BUSH, GEORGE H.W.",1001619,1084953,1084953,1001619,41668,R,11,538,112,426,R,True
179,1988,MONTANA,MT,359348,"DUKAKIS, MICHAEL","BUSH, GEORGE H.W.",168936,190412,190412,168936,10739,R,4,538,112,426,R,True
180,1988,NEBRASKA,NE,657191,"DUKAKIS, MICHAEL","BUSH, GEORGE H.W.",259235,397956,397956,259235,69361,R,5,538,112,426,R,True
181,1988,NEVADA,NV,338778,"DUKAKIS, MICHAEL","BUSH, GEORGE H.W.",132738,206040,206040,132738,36652,R,4,538,112,426,R,True
182,1988,NEW HAMPSHIRE,NH,445233,"DUKAKIS, MICHAEL","BUSH, GEORGE H.W.",163696,281537,281537,163696,58921,R,4,538,112,426,R,True
183,1988,NEW JERSEY,NJ,3063544,"DUKAKIS, MICHAEL","BUSH, GEORGE H.W.",1320352,1743192,1743192,1320352,211421,R,16,538,112,426,R,True
184,1988,NEW MEXICO,NM,514838,"DUKAKIS, MICHAEL","BUSH, GEORGE H.W.",244497,270341,270341,244497,12923,R,5,538,112,426,R,True
185,1988,NEW YORK,NY,6093901,"DUKAKIS, MICHAEL","BUSH, GEORGE H.W.",3255487,2838414,3255487,2838414,208537,D,36,538,112,426,R,False
186,1988,NORTH CAROLINA,NC,2127425,"DUKAKIS, MICHAEL","BUSH, GEORGE H.W.",890167,1237258,1237258,890167,173546,R,13,538,112,426,R,True
187,1988,NORTH DAKOTA,ND,294298,"DUKAKIS, MICHAEL","BUSH, GEORGE H.W.",127739,166559,166559,127739,19411,R,3,538,112,426,R,True
188,1988,OHIO,OH,4356178,"DUKAKIS, MICHAEL","BUSH, GEORGE H.W.",1939629,2416549,2416549,1939629,238461,R,23,538,112,426,R,True
189,1988,OKLAHOMA,OK,1161790,"DUKAKIS, MICHAEL","BUSH, GEORGE H.W.",483423,678367,678367,483423,97473,R,8,538,112,426,R,True
190,1988,OREGON,OR,1176332,"DUKAKIS, MICHAEL","BUSH, GEORGE H.W.",616206,560126,616206,560126,28041,D,7,538,112,426,R,False
191,1988,PENNSYLVANIA,PA,4495031,"DUKAKIS, MICHAEL","BUSH, GEORGE H.W.",2194944,2300087,2300087,2194944,52572,R,25,538,112,426,R,True
192,1988,RHODE ISLAND,RI,402884,"DUKAKIS, MICHAEL","BUSH, GEORGE H.W.",225123,177761,225123,177761,23682,D,4,538,112,426,R,False
193,1988,SOUTH CAROLINA,SC,976997,"DUKAKIS, MICHAEL","BUSH, GEORGE H.W.",370554,606443,606443,370554,117945,R,8,538,112,426,R,True
194,1988,SOUTH DAKOTA,SD,310975,"DUKAKIS, MICHAEL","BUSH, GEORGE H.W.",145560,165415,165415,145560,9928,R,3,538,112,426,R,True
195,1988,TENNESSEE,TN,1627027,"DUKAKIS, MICHAEL","BUSH, GEORGE H.W.",679794,947233,947233,679794,133720,R,11,538,112,426,R,True
196,1988,TEXAS,TX,5389577,"DUKAKIS, MICHAEL","BUSH, GEORGE H.W.",2352748,3036829,3036829,2352748,342041,R,29,538,112,426,R,True
197,1988,UTAH,UT,635785,"DUKAKIS, MICHAEL","BUSH, GEORGE H.W.",207343,428442,428442,207343,110550,R,5,538,112,426,R,True
198,1988,VERMONT,VT,240106,"DUKAKIS, MICHAEL","BUSH, GEORGE H.W.",115775,124331,124331,115775,4279,R,3,538,112,426,R,True
199,1988,VIRGINIA,VA,2168961,"DUKAKIS, MICHAEL","BUSH, GEORGE H.W.",859799,1309162,1309162,859799,224682,R,12,538,112,426,R,True
200,1988,WASHINGTON,WA,1837351,"DUKAKIS, MICHAEL","BUSH, GEORGE H.W.",933516,903835,933516,903835,14841,D,10,538,112,426,R,False
201,1988,WEST VIRGINIA,WV,651081,"DUKAKIS, MICHAEL","BUSH, GEORGE H.W.",341016,310065,341016,310065,15476,D,6,538,112,426,R,False
202,1988,WISCONSIN,WI,2174293,"DUKAKIS, MICHAEL","BUSH, GEORGE H.W.",1126794,1047499,1126794,1047499,39648,D,11,538,112,426,R,False
203,1988,WYOMING,WY,173980,"DUKAKIS, MICHAEL","BUSH, GEORGE H.W.",67113,106867,106867,67113,19878,R,3,538,112,426,R,True
204,1992,ALABAMA,AL,1494363,"CLINTON, BILL","BUSH, GEORGE H.W.",690080,804283,804283,690080,57102,R,9,538,370,168,D,False
205,1992,ALASKA,AK,180294,"CLINTON, BILL","BUSH, GEORGE H.W.",78294,102000,102000,78294,11854,R,3,538,370,168,D,False
206,1992,ARIZONA,AZ,1115136,"CLINTON, BILL","BUSH, GEORGE H.W.",543050,572086,572086,543050,14519,R,8,538,370,168,D,False
207,1992,ARKANSAS,AR,843147,"CLINTON, BILL","BUSH, GEORGE H.W.",505823,337324,505823,337324,84250,D,6,538,370,168,D,True
208,1992,CALIFORNIA,CA,8751899,"CLINTON, BILL","BUSH, GEORGE H.W.",5121325,3630574,5121325,3630574,745376,D,54,538,370,168,D,True
209,1992,COLORADO,CO,1192531,"CLINTON, BILL","BUSH, GEORGE H.W.",629681,562850,629681,562850,33416,D,8,538,370,168,D,True
210,1992,CONNECTICUT,CT,1260631,"CLINTON, BILL","BUSH, GEORGE H.W.",682318,578313,682318,578313,52003,D,8,538,370,168,D,True
211,1992,DELAWARE,DE,228367,"CLINTON, BILL","BUSH, GEORGE H.W.",126054,102313,126054,102313,11871,D,3,538,370,168,D,True
212,1992,D.C.,DC,213317,"CLINTON, BILL","BUSH, GEORGE H.W.",192619,20698,192619,20698,85961,D,3,538,370,168,D,True
213,1992,FLORIDA,FL,4245008,"CLINTON, BILL","BUSH, GEORGE H.W.",2071698,2173310,2173310,2071698,50807,R,25,538,370,168,D,False
214,1992,GEORGIA,GA,2004218,"CLINTON, BILL","BUSH, GEORGE H.W.",1008966,995252,1008966,995252,6858,D,13,538,370,168,D,True
215,1992,HAWAII,HI,316132,"CLINTON, BILL","BUSH, GEORGE H.W.",179310,136822,179310,136822,21245,D,4,538,370,168,D,True
216,1992,IDAHO,ID,339658,"CLINTON, BILL","BUSH, GEORGE H.W.",137013,202645,202645,137013,32817,R,4,538,370,168,D,False
217,1992,ILLINOIS,IL,4187446,"CLINTON, BILL","BUSH, GEORGE H.W.",2453350,1734096,2453350,1734096,359628,D,22,538,370,168,D,True
218,1992,INDIANA,IN,1837795,"CLINTON, BILL","BUSH, GEORGE H.W.",848420,989375,989375,848420,70478,R,12,538,370,168,D,False
219,1992,IOWA,IA,1091244,"CLINTON, BILL","BUSH, GEORGE H.W.",586353,504891,586353,504891,40732,D,7,538,370,168,D,True
220,1992,KANSAS,KS,840385,"CLINTON, BILL","BUSH, GEORGE H.W.",390434,449951,449951,390434,29759,R,6,538,370,168,D,False
221,1992,KENTUCKY,KY,1282282,"CLINTON, BILL","BUSH, GEORGE H.W.",665104,617178,665104,617178,23964,D,8,538,370,168,D,True
222,1992,LOUISIANA,LA,1549357,"CLINTON, BILL","BUSH, GEORGE H.W.",815971,733386,815971,733386,41293,D,9,538,370,168,D,True
223,1992,MAINE,ME,469924,"CLINTON, BILL","BUSH, GEORGE H.W.",263420,206504,263420,206504,28459,D,4,538,370,168,D,True
224,1992,MARYLAND,MD,1695665,"CLINTON, BILL","BUSH, GEORGE H.W.",988571,707094,988571,707094,140739,D,10,538,370,168,D,True
225,1992,MASSACHUSETTS,MA,2123678,"CLINTON, BILL","BUSH, GEORGE H.W.",1318639,805039,1318639,805039,256801,D,12,538,370,168,D,True
226,1992,MICHIGAN,MI,3426122,"CLINTON, BILL","BUSH, GEORGE H.W.",1871182,1554940,1871182,1554940,158122,D,18,538,370,168,D,True
227,1992,MINNESOTA,MN,1768838,"CLINTON, BILL","BUSH, GEORGE H.W.",1020997,747841,1020997,747841,136579,D,10,538,370,168,D,True
228,1992,MISSISSIPPI,MS,888051,"CLINTON, BILL","BUSH, GEORGE H.W.",400258,487793,487793,400258,43768,R,7,538,370,168,D,False
229,1992,MISSOURI,MO,1865032,"CLINTON, BILL","BUSH, GEORGE H.W.",1053873,811159,1053873,811159,121358,D,11,538,370,168,D,True
230,1992,MONTANA,MT,298714,"CLINTON, BILL","BUSH, GEORGE H.W.",154507,144207,154507,144207,5151,D,3,538,370,168,D,True
231,1992,NEBRASKA,NE,560542,"CLINTON, BILL","BUSH, GEORGE H.W.",216864,343678,343678,216864,63408,R,5,538,370,168,D,False
232,1992,NEVADA,NV,364976,"CLINTON, BILL","BUSH, GEORGE H.W.",189148,175828,189148,175828,6661,D,4,538,370,168,D,True
233,1992,NEW HAMPSHIRE,NH,411524,"CLINTON, BILL","BUSH, GEORGE H.W.",209040,202484,209040,202484,3279,D,4,538,370,168,D,True
234,1992,NEW JERSEY,NJ,2793071,"CLINTON, BILL","BUSH, GEORGE H.W.",1436206,1356865,1436206,1356865,39671,D,15,538,370,168,D,True
235,1992,NEW MEXICO,NM,474441,"CLINTON, BILL","BUSH, GEORGE H.W.",261617,212824,261617,212824,24397,D,5,538,370,168,D,True
236,1992,NEW YORK,NY,5388584,"CLINTON, BILL","BUSH, GEORGE H.W.",3346894,2041690,3346894,2041690,652603,D,33,538,370,168,D,True
237,1992,NORTH CAROLINA,NC,2248703,"CLINTON, BILL","BUSH, GEORGE H.W.",1114042,1134661,1134661,1114042,10310,R,14,538,370,168,D,False
238,1992,NORTH DAKOTA,ND,235412,"CLINTON, BILL","BUSH, GEORGE H.W.",99168,136244,136244,99168,18539,R,3,538,370,168,D,False
239,1992,OHIO,OH,3879252,"CLINTON, BILL","BUSH, GEORGE H.W.",1984942,1894310,1984942,1894310,45317,D,21,538,370,168,D,True
240,1992,OKLAHOMA,OK,1065995,"CLINTON, BILL","BUSH, GEORGE H.W.",473066,592929,592929,473066,59932,R,8,538,370,168,D,False
241,1992,OREGON,OR,1097071,"CLINTON, BILL","BUSH, GEORGE H.W.",621314,475757,621314,475757,72779,D,7,538,370,168,D,True
242,1992,PENNSYLVANIA,PA,4031005,"CLINTON, BILL","BUSH, GEORGE H.W.",2239164,1791841,2239164,1791841,223662,D,23,538,370,168,D,True
243,1992,RHODE ISLAND,RI,344900,"CLINTON, BILL","BUSH, GEORGE H.W.",213299,131601,213299,131601,40850,D,4,538,370,168,D,True
244,1992,SOUTH CAROLINA,SC,1103021,"CLINTON, BILL","BUSH, GEORGE H.W.",525514,577507,577507,525514,25997,R,8,538,370,168,D,False
245,1992,SOUTH DAKOTA,SD,261606,"CLINTON, BILL","BUSH, GEORGE H.W.",124888,136718,136718,124888,5916,R,3,538,370,168,D,False
246,1992,TENNESSEE,TN,1774821,"CLINTON, BILL","BUSH, GEORGE H.W.",933521,841300,933521,841300,46111,D,11,538,370,168,D,True
247,1992,TEXAS,TX,4777886,"CLINTON, BILL","BUSH, GEORGE H.W.",2281815,2496071,2496071,2281815,107129,R,32,538,370,168,D,False
248,1992,UTAH,UT,506061,"CLINTON, BILL","BUSH, GEORGE H.W.",183429,322632,322632,183429,69602,R,5,538,370,168,D,False
249,1992,VERMONT,VT,221714,"CLINTON, BILL","BUSH, GEORGE H.W.",133592,88122,133592,88122,22736,D,3,538,370,168,D,True
250,1992,VIRGINIA,VA,2189167,"CLINTON, BILL","BUSH, GEORGE H.W.",1038650,1150517,1150517,1038650,55934,R,13,538,370,168,D,False
251,1992,WASHINGTON,WA,1724271,"CLINTON, BILL","BUSH, GEORGE H.W.",993037,731234,993037,731234,130902,D,11,538,370,168,D,True
252,1992,WEST VIRGINIA,WV,572975,"CLINTON, BILL","BUSH, GEORGE H.W.",331001,241974,331001,241974,44514,D,5,538,370,168,D,True
253,1992,WISCONSIN,WI,1971921,"CLINTON, BILL","BUSH, GEORGE H.W.",1041066,930855,1041066,930855,55106,D,11,538,370,168,D,True
254,1992,WYOMING,WY,147507,"CLINTON, BILL","BUSH, GEORGE H.W.",68160,79347,79347,68160,5594,R,3,538,370,168,D,False
255,1996,ALABAMA,AL,1431209,"CLINTON, BILL","DOLE, ROBERT",662165,769044,769044,662165,53440,R,9,538,379,159,D,False
256,1996,ALASKA,AK,203126,"CLINTON, BILL","DOLE, ROBERT",80380,122746,122746,80380,21184,R,3,538,379,159,D,False
257,1996,ARIZONA,AZ,1275361,"CLINTON, BILL","DOLE, ROBERT",653288,622073,653288,622073,15608,D,8,538,379,159,D,True
258,1996,ARKANSAS,AR,800587,"CLINTON, BILL","DOLE, ROBERT",475171,325416,475171,325416,74878,D,6,538,379,159,D,True
259,1996,CALIFORNIA,CA,8948216,"CLINTON, BILL","DOLE, ROBERT",5119835,3828381,5119835,3828381,645728,D,54,538,379,159,D,True
260,1996,COLORADO,CO,1363000,"CLINTON, BILL","DOLE, ROBERT",671152,691848,691848,671152,10349,R,8,538,379,159,D,False
261,1996,CONNECTICUT,CT,1218849,"CLINTON, BILL","DOLE, ROBERT",735740,483109,735740,483109,126316,D,8,538,379,159,D,True
262,1996,DELAWARE,DE,239417,"CLINTON, BILL","DOLE, ROBERT",140355,99062,140355,99062,20647,D,3,538,379,159,D,True
263,1996,D.C.,DC,175559,"CLINTON, BILL","DOLE, ROBERT",158220,17339,158220,17339,70441,D,3,538,379,159,D,True
264,1996,FLORIDA,FL,4791406,"CLINTON, BILL","DOLE, ROBERT",2546870,2244536,2546870,2244536,151168,D,25,538,379,159,D,True
265,1996,GEORGIA,GA,2134692,"CLINTON, BILL","DOLE, ROBERT",1053849,1080843,1080843,1053849,13498,R,13,538,379,159,D,False
266,1996,HAWAII,HI,318955,"CLINTON, BILL","DOLE, ROBERT",205012,113943,205012,113943,45535,D,4,538,379,159,D,True
267,1996,IDAHO,ID,422038,"CLINTON, BILL","DOLE, ROBERT",165443,256595,256595,165443,45577,R,4,538,379,159,D,False
268,1996,ILLINOIS,IL,3928765,"CLINTON, BILL","DOLE, ROBERT",2341744,1587021,2341744,1587021,377362,D,22,538,379,159,D,True
269,1996,INDIANA,IN,1894117,"CLINTON, BILL","DOLE, ROBERT",887424,1006693,1006693,887424,59635,R,12,538,379,159,D,False
270,1996,IOWA,IA,1112902,"CLINTON, BILL","DOLE, ROBERT",620258,492644,620258,492644,63808,D,7,538,379,159,D,True
271,1996,KANSAS,KS,970904,"CLINTON, BILL","DOLE, ROBERT",387659,583245,583245,387659,97794,R,6,538,379,159,D,False
272,1996,KENTUCKY,KY,1259897,"CLINTON, BILL","DOLE, ROBERT",636614,623283,636614,623283,6666,D,8,538,379,159,D,True
273,1996,LOUISIANA,LA,1640423,"CLINTON, BILL","DOLE, ROBERT",927837,712586,927837,712586,107626,D,9,538,379,159,D,True
274,1996,MAINE,ME,499166,"CLINTON, BILL","DOLE, ROBERT",312788,186378,312788,186378,63206,D,4,538,379,159,D,True
275,1996,MARYLAND,MD,1647737,"CLINTON, BILL","DOLE, ROBERT",966207,681530,966207,681530,142339,D,10,538,379,159,D,True
276,1996,MASSACHUSETTS,MA,2289567,"CLINTON, BILL","DOLE, ROBERT",1571509,718058,1571509,718058,426726,D,12,538,379,159,D,True
277,1996,MICHIGAN,MI,3470865,"CLINTON, BILL","DOLE, ROBERT",1989653,1481212,1989653,1481212,254221,D,18,538,379,159,D,True
278,1996,MINNESOTA,MN,1886775,"CLINTON, BILL","DOLE, ROBERT",1120380,766395,1120380,766395,176993,D,10,538,379,159,D,True
279,1996,MISSISSIPPI,MS,833860,"CLINTON, BILL","DOLE, ROBERT",394022,439838,439838,394022,22909,R,7,538,379,159,D,False
280,1996,MISSOURI,MO,1915951,"CLINTON, BILL","DOLE, ROBERT",1025935,890016,1025935,890016,67960,D,11,538,379,159,D,True
281,1996,MONTANA,MT,347574,"CLINTON, BILL","DOLE, ROBERT",167922,179652,179652,167922,5866,R,3,538,379,159,D,False
282,1996,NEBRASKA,NE,600228,"CLINTON, BILL","DOLE, ROBERT",236761,363467,363467,236761,63354,R,5,538,379,159,D,False
283,1996,NEVADA,NV,403218,"CLINTON, BILL","DOLE, ROBERT",203974,199244,203974,199244,2366,D,4,538,379,159,D,True
284,1996,NEW HAMPSHIRE,NH,442652,"CLINTON, BILL","DOLE, ROBERT",246166,196486,246166,196486,24841,D,4,538,379,159,D,True
285,1996,NEW JERSEY,NJ,2755460,"CLINTON, BILL","DOLE, ROBERT",1652361,1103099,1652361,1103099,274632,D,15,538,379,159,D,True
286,1996,NEW MEXICO,NM,506246,"CLINTON, BILL","DOLE, ROBERT",273495,232751,273495,232751,20373,D,5,538,379,159,D,True
287,1996,NEW YORK,NY,5388337,"CLINTON, BILL","DOLE, ROBERT",3649630,1738707,3649630,1738707,955462,D,33,538,379,159,D,True
288,1996,NORTH CAROLINA,NC,2333787,"CLINTON, BILL","DOLE, ROBERT",1107849,1225938,1225938,1107849,59045,R,14,538,379,159,D,False
289,1996,NORTH DAKOTA,ND,231955,"CLINTON, BILL","DOLE, ROBERT",106905,125050,125050,106905,9073,R,3,538,379,159,D,False
290,1996,OHIO,OH,4008105,"CLINTON, BILL","DOLE, ROBERT",2148222,1859883,2148222,1859883,144170,D,21,538,379,159,D,True
291,1996,OKLAHOMA,OK,1070420,"CLINTON, BILL","DOLE, ROBERT",488105,582315,582315,488105,47106,R,8,538,379,159,D,False
292,1996,OREGON,OR,1187793,"CLINTON, BILL","DOLE, ROBERT",649641,538152,649641,538152,55745,D,7,538,379,159,D,True
293,1996,PENNSYLVANIA,PA,4016988,"CLINTON, BILL","DOLE, ROBERT",2215819,1801169,2215819,1801169,207326,D,23,538,379,159,D,True
294,1996,RHODE ISLAND,RI,337733,"CLINTON, BILL","DOLE, ROBERT",233050,104683,233050,104683,64184,D,4,538,379,159,D,True
295,1996,SOUTH CAROLINA,SC,1079491,"CLINTON, BILL","DOLE, ROBERT",506152,573339,573339,506152,33594,R,8,538,379,159,D,False
296,1996,SOUTH DAKOTA,SD,289876,"CLINTON, BILL","DOLE, ROBERT",139333,150543,150543,139333,5606,R,3,538,379,159,D,False
297,1996,TENNESSEE,TN,1772676,"CLINTON, BILL","DOLE, ROBERT",909146,863530,909146,863530,22809,D,11,538,379,159,D,True
298,1996,TEXAS,TX,5195850,"CLINTON, BILL","DOLE, ROBERT",2459683,2736167,2736167,2459683,138243,R,32,538,379,159,D,False
299,1996,UTAH,UT,583544,"CLINTON, BILL","DOLE, ROBERT",221633,361911,361911,221633,70140,R,5,538,379,159,D,False
300,1996,VERMONT,VT,218246,"CLINTON, BILL","DOLE, ROBERT",137894,80352,137894,80352,28772,D,3,538,379,159,D,True
301,1996,VIRGINIA,VA,2229410,"CLINTON, BILL","DOLE, ROBERT",1091060,1138350,1138350,1091060,23646,R,13,538,379,159,D,False
302,1996,WASHINGTON,WA,1964035,"CLINTON, BILL","DOLE, ROBERT",1123323,840712,1123323,840712,141306,D,11,538,379,159,D,True
303,1996,WEST VIRGINIA,WV,561758,"CLINTON, BILL","DOLE, ROBERT",327812,233946,327812,233946,46934,D,5,538,379,159,D,True
304,1996,WISCONSIN,WI,1917000,"CLINTON, BILL","DOLE, ROBERT",1071971,845029,1071971,845029,113472,D,11,538,379,159,D,True
305,1996,WYOMING,WY,183322,"CLINTON, BILL","DOLE, ROBERT",77934,105388,105388,77934,13728,R,3,538,379,159,D,False
306,2000,ALABAMA,AL,1633784,"GORE, AL","BUSH, GEORGE W.",692611,941173,941173,692611,124282,R,9,538,267,271,R,True
307,2000,ALASKA,AK,246402,"GORE, AL","BUSH, GEORGE W.",79004,167398,167398,79004,44198,R,3,538,267,271,R,True
308,2000,ARIZONA,AZ,1466993,"GORE, AL","BUSH, GEORGE W.",685341,781652,781652,685341,48156,R,8,538,267,271,R,True
309,2000,ARKANSAS,AR,895708,"GORE, AL","BUSH, GEORGE W.",422768,472940,472940,422768,25087,R,6,538,267,271,R,True
310,2000,CALIFORNIA,CA,10428632,"GORE, AL","BUSH, GEORGE W.",5861203,4567429,5861203,4567429,646888,D,54,538,267,271,R,False
311,2000,COLORADO,CO,1621975,"GORE, AL","BUSH, GEORGE W.",738227,883748,883748,738227,72761,R,8,538,267,271,R,True
312,2000,CONNECTICUT,CT,1377109,"GORE, AL","BUSH, GEORGE W.",816015,561094,816015,561094,127461,D,8,538,267,271,R,False
313,2000,DELAWARE,DE,317356,"GORE, AL","BUSH, GEORGE W.",180068,137288,180068,137288,21391,D,3,538,267,271,R,False
314,2000,D.C.,DC,189996,"GORE, AL","BUSH, GEORGE W.",171923,18073,171923,18073,76926,D,3,538,267,271,R,False
315,2000,FLORIDA,FL,5825043,"GORE, AL","BUSH, GEORGE W.",2912253,2912790,2912790,2912253,269,R,25,538,267,271,R,True
316,2000,GEORGIA,GA,2535950,"GORE, AL","BUSH, GEORGE W.",1116230,1419720,1419720,1116230,151746,R,13,538,267,271,R,True
317,2000,HAWAII,HI,343131,"GORE, AL","BUSH, GEORGE W.",205286,137845,205286,137845,33721,D,4,538,267,271,R,False
318,2000,IDAHO,ID,475574,"GORE, AL","BUSH, GEORGE W.",138637,336937,336937,138637,99151,R,4,538,267,271,R,True
319,2000,ILLINOIS,IL,4608447,"GORE, AL","BUSH, GEORGE W.",2589026,2019421,2589026,2019421,284803,D,22,538,267,271,R,False
320,2000,INDIANA,IN,2147816,"GORE, AL","BUSH, GEORGE W.",901980,1245836,1245836,901980,171929,R,12,538,267,271,R,True
321,2000,IOWA,IA,1272890,"GORE, AL","BUSH, GEORGE W.",638517,634373,638517,634373,2073,D,7,538,267,271,R,False
322,2000,KANSAS,KS,1021608,"GORE, AL","BUSH, GEORGE W.",399276,622332,622332,399276,111529,R,6,538,267,271,R,True
323,2000,KENTUCKY,KY,1511443,"GORE, AL","BUSH, GEORGE W.",638923,872520,872520,638923,116799,R,8,538,267,271,R,True
324,2000,LOUISIANA,LA,1720215,"GORE, AL","BUSH, GEORGE W.",792344,927871,927871,792344,67764,R,9,538,267,271,R,True
325,2000,MAINE,ME,606567,"GORE, AL","BUSH, GEORGE W.",319951,286616,319951,286616,16668,D,4,538,267,271,R,False
326,2000,MARYLAND,MD,1957835,"GORE, AL","BUSH, GEORGE W.",1144008,813827,1144008,813827,165091,D,10,538,267,271,R,False
327,2000,MASSACHUSETTS,MA,2494989,"GORE, AL","BUSH, GEORGE W.",1616487,878502,1616487,878502,368993,D,12,538,267,271,R,False
328,2000,MICHIGAN,MI,4123557,"GORE, AL","BUSH, GEORGE W.",2170418,1953139,2170418,1953139,108640,D,18,538,267,271,R,False
329,2000,MINNESOTA,MN,2277925,"GORE, AL","BUSH, GEORGE W.",1168266,1109659,1168266,1109659,29304,D,10,538,267,271,R,False
330,2000,MISSISSIPPI,MS,977458,"GORE, AL","BUSH, GEORGE W.",404614,572844,572844,404614,84116,R,7,538,267,271,R,True
331,2000,MISSOURI,MO,2301062,"GORE, AL","BUSH, GEORGE W.",1111138,1189924,1189924,1111138,39394,R,11,538,267,271,R,True
332,2000,MONTANA,MT,377304,"GORE, AL","BUSH, GEORGE W.",137126,240178,240178,137126,51527,R,3,538,267,271,R,True
333,2000,NEBRASKA,NE,665642,"GORE, AL","BUSH, GEORGE W.",231780,433862,433862,231780,101042,R,5,538,267,271,R,True
334,2000,NEVADA,NV,581553,"GORE, AL","BUSH, GEORGE W.",279978,301575,301575,279978,10799,R,4,538,267,271,R,True
335,2000,NEW HAMPSHIRE,NH,539907,"GORE, AL","BUSH, GEORGE W.",266348,273559,273559,266348,3606,R,4,538,267,271,R,True
336,2000,NEW JERSEY,NJ,3073023,"GORE, AL","BUSH, GEORGE W.",1788850,1284173,1788850,1284173,252339,D,15,538,267,271,R,False
337,2000,NEW MEXICO,NM,573200,"GORE, AL","BUSH, GEORGE W.",286783,286417,286783,286417,184,D,5,538,267,271,R,False
338,2000,NEW YORK,NY,6200792,"GORE, AL","BUSH, GEORGE W.",3942215,2258577,3942215,2258577,841820,D,33,538,267,271,R,False
339,2000,NORTH CAROLINA,NC,2888855,"GORE, AL","BUSH, GEORGE W.",1257692,1631163,1631163,1257692,186736,R,14,538,267,271,R,True
340,2000,NORTH DAKOTA,ND,270136,"GORE, AL","BUSH, GEORGE W.",95284,174852,174852,95284,39785,R,3,538,267,271,R,True
341,2000,OHIO,OH,4533991,"GORE, AL","BUSH, GEORGE W.",2183628,2350363,2350363,2183628,83368,R,21,538,267,271,R,True
342,2000,OKLAHOMA,OK,1218613,"GORE, AL","BUSH, GEORGE W.",474276,744337,744337,474276,135031,R,8,538,267,271,R,True
343,2000,OREGON,OR,1433919,"GORE, AL","BUSH, GEORGE W.",720342,713577,720342,713577,3383,D,7,538,267,271,R,False
344,2000,PENNSYLVANIA,PA,4767094,"GORE, AL","BUSH, GEORGE W.",2485967,2281127,2485967,2281127,102421,D,23,538,267,271,R,False
345,2000,RHODE ISLAND,RI,380063,"GORE, AL","BUSH, GEORGE W.",249508,130555,249508,130555,59477,D,4,538,267,271,R,False
346,2000,SOUTH CAROLINA,SC,1352929,"GORE, AL","BUSH, GEORGE W.",566037,786892,786892,566037,110428,R,8,538,267,271,R,True
347,2000,SOUTH DAKOTA,SD,309504,"GORE, AL","BUSH, GEORGE W.",118804,190700,190700,118804,35949,R,3,538,267,271,R,True
348,2000,TENNESSEE,TN,2043669,"GORE, AL","BUSH, GEORGE W.",981720,1061949,1061949,981720,40115,R,11,538,267,271,R,True
349,2000,TEXAS,TX,6233385,"GORE, AL","BUSH, GEORGE W.",2433746,3799639,3799639,2433746,682947,R,32,538,267,271,R,True
350,2000,UTAH,UT,718149,"GORE, AL","BUSH, GEORGE W.",203053,515096,515096,203053,156022,R,5,538,267,271,R,True
351,2000,VERMONT,VT,268797,"GORE, AL","BUSH, GEORGE W.",149022,119775,149022,119775,14624,D,3,538,267,271,R,False
352,2000,VIRGINIA,VA,2654780,"GORE, AL","BUSH, GEORGE W.",1217290,1437490,1437490,1217290,110101,R,13,538,267,271,R,True
353,2000,WASHINGTON,WA,2356516,"GORE, AL","BUSH, GEORGE W.",1247652,1108864,1247652,1108864,69395,D,11,538,267,271,R,False
354,2000,WEST VIRGINIA,WV,631972,"GORE, AL","BUSH, GEORGE W.",295497,336475,336475,295497,20490,R,5,538,267,271,R,True
355,2000,WISCONSIN,WI,2480266,"GORE, AL","BUSH, GEORGE W.",1242987,1237279,1242987,1237279,2855,D,11,538,267,271,R,False
356,2000,WYOMING,WY,208428,"GORE, AL","BUSH, GEORGE W.",60481,147947,147947,60481,43734,R,3,538,267,271,R,True
357,2004,ALABAMA,AL,1870327,"KERRY, JOHN","BUSH, GEORGE W.",693933,1176394,1176394,693933,241231,R,9,538,252,286,R,True
358,2004,ALASKA,AK,301914,"KERRY, JOHN","BUSH, GEORGE W.",111025,190889,190889,111025,39933,R,3,538,252,286,R,True
359,2004,ARIZONA,AZ,1997818,"KERRY, JOHN","BUSH, GEORGE W.",893524,1104294,1104294,893524,105386,R,10,538,252,286,R,True
360,2004,ARKANSAS,AR,1042851,"KERRY, JOHN","BUSH, GEORGE W.",469953,572898,572898,469953,51473,R,6,538,252,286,R,True
361,2004,CALIFORNIA,CA,12255311,"KERRY, JOHN","BUSH, GEORGE W.",6745485,5509826,6745485,5509826,617830,D,55,538,252,286,R,False
362,2004,COLORADO,CO,2102987,"KERRY, JOHN","BUSH, GEORGE W.",1001732,1101255,1101255,1001732,49762,R,9,538,252,286,R,True
363,2004,CONNECTICUT,CT,1551314,"KERRY, JOHN","BUSH, GEORGE W.",857488,693826,857488,693826,81832,D,7,538,252,286,R,False
364,2004,DELAWARE,DE,371812,"KERRY, JOHN","BUSH, GEORGE W.",200152,171660,200152,171660,14247,D,3,538,252,286,R,False
365,2004,D.C.,DC,224226,"KERRY, JOHN","BUSH, GEORGE W.",202970,21256,202970,21256,90858,D,3,538,252,286,R,False
366,2004,FLORIDA,FL,7548066,"KERRY, JOHN","BUSH, GEORGE W.",3583544,3964522,3964522,3583544,190490,R,27,538,252,286,R,True
367,2004,GEORGIA,GA,3280403,"KERRY, JOHN","BUSH, GEORGE W.",1366149,1914254,1914254,1366149,274053,R,15,538,252,286,R,True
368,2004,HAWAII,HI,425899,"KERRY, JOHN","BUSH, GEORGE W.",231708,194191,231708,194191,18759,D,4,538,252,286,R,False
369,2004,IDAHO,ID,590333,"KERRY, JOHN","BUSH, GEORGE W.",181098,409235,409235,181098,114069,R,4,538,252,286,R,True
370,2004,ILLINOIS,IL,5237496,"KERRY, JOHN","BUSH, GEORGE W.",2891550,2345946,2891550,2345946,272803,D,21,538,252,286,R,False
371,2004,INDIANA,IN,2448449,"KERRY, JOHN","BUSH, GEORGE W.",969011,1479438,1479438,969011,255214,R,11,538,252,286,R,True
372,2004,IOWA,IA,1493855,"KERRY, JOHN","BUSH, GEORGE W.",741898,751957,751957,741898,5030,R,7,538,252,286,R,True
373,2004,KANSAS,KS,1171449,"KERRY, JOHN","BUSH, GEORGE W.",434993,736456,736456,434993,150732,R,6,538,252,286,R,True
374,2004,KENTUCKY,KY,1782172,"KERRY, JOHN","BUSH, GEORGE W.",712733,1069439,1069439,712733,178354,R,8,538,252,286,R,True
375,2004,LOUISIANA,LA,1922468,"KERRY, JOHN","BUSH, GEORGE W.",820299,1102169,1102169,820299,140936,R,9,538,252,286,R,True
376,2004,MAINE,ME,727043,"KERRY, JOHN","BUSH, GEORGE W.",396842,330201,396842,330201,33321,D,4,538,252,286,R,False
377,2004,MARYLAND,MD,2359196,"KERRY, JOHN","BUSH, GEORGE W.",1334493,1024703,1334493,1024703,154896,D,10,538,252,286,R,False
378,2004,MASSACHUSETTS,MA,2874909,"KERRY, JOHN","BUSH, GEORGE W.",1803800,1071109,1803800,1071109,366346,D,12,538,252,286,R,False
379,2004,MICHIGAN,MI,4792929,"KERRY, JOHN","BUSH, GEORGE W.",2479183,2313746,2479183,2313746,82719,D,17,538,252,286,R,False
380,2004,MINNESOTA,MN,2791709,"KERRY, JOHN","BUSH, GEORGE W.",1445014,1346695,1445014,1346695,49160,D,10,538,252,286,R,False
381,2004,MISSISSIPPI,MS,1130426,"KERRY, JOHN","BUSH, GEORGE W.",457766,672660,672660,457766,107448,R,6,538,252,286,R,True
382,2004,MISSOURI,MO,2714884,"KERRY, JOHN","BUSH, GEORGE W.",1259171,1455713,1455713,1259171,98272,R,11,538,252,286,R,True
383,2004,MONTANA,MT,439773,"KERRY, JOHN","BUSH, GEORGE W.",173710,266063,266063,173710,46177,R,3,538,252,286,R,True
384,2004,NEBRASKA,NE,767142,"KERRY, JOHN","BUSH, GEORGE W.",254328,512814,512814,254328,129244,R,5,538,252,286,R,True
385,2004,NEVADA,NV,815880,"KERRY, JOHN","BUSH, GEORGE W.",397190,418690,418690,397190,10751,R,5,538,252,286,R,True
386,2004,NEW HAMPSHIRE,NH,671748,"KERRY, JOHN","BUSH, GEORGE W.",340511,331237,340511,331237,4638,D,4,538,252,286,R,False
387,2004,NEW JERSEY,NJ,3581433,"KERRY, JOHN","BUSH, GEORGE W.",1911430,1670003,1911430,1670003,120714,D,15,538,252,286,R,False
388,2004,NEW MEXICO,NM,747872,"KERRY, JOHN","BUSH, GEORGE W.",370942,376930,376930,370942,2995,R,5,538,252,286,R,True
389,2004,NEW YORK,NY,6987748,"KERRY, JOHN","BUSH, GEORGE W.",4180755,2806993,4180755,2806993,686882,D,31,538,252,286,R,False
390,2004,NORTH CAROLINA,NC,3487015,"KERRY, JOHN","BUSH, GEORGE W.",1525849,1961166,1961166,1525849,217659,R,15,538,252,286,R,True
391,2004,NORTH DAKOTA,ND,307703,"KERRY, JOHN","BUSH, GEORGE W.",111052,196651,196651,111052,42800,R,3,538,252,286,R,True
392,2004,OHIO,OH,5600929,"KERRY, JOHN","BUSH, GEORGE W.",2741165,2859764,2859764,2741165,59300,R,20,538,252,286,R,True
393,2004,OKLAHOMA,OK,1463758,"KERRY, JOHN","BUSH, GEORGE W.",503966,959792,959792,503966,227914,R,7,538,252,286,R,True
394,2004,OREGON,OR,1809994,"KERRY, JOHN","BUSH, GEORGE W.",943163,866831,943163,866831,38167,D,7,538,252,286,R,False
395,2004,PENNSYLVANIA,PA,5731942,"KERRY, JOHN","BUSH, GEORGE W.",2938095,2793847,2938095,2793847,72125,D,21,538,252,286,R,False
396,2004,RHODE ISLAND,RI,428806,"KERRY, JOHN","BUSH, GEORGE W.",259760,169046,259760,169046,45358,D,4,538,252,286,R,False
397,2004,SOUTH CAROLINA,SC,1599643,"KERRY, JOHN","BUSH, GEORGE W.",661669,937974,937974,661669,138153,R,8,538,252,286,R,True
398,2004,SOUTH DAKOTA,SD,381828,"KERRY, JOHN","BUSH, GEORGE W.",149244,232584,232584,149244,41671,R,3,538,252,286,R,True
399,2004,TENNESSEE,TN,2420852,"KERRY, JOHN","BUSH, GEORGE W.",1036477,1384375,1384375,1036477,173950,R,11,538,252,286,R,True
400,2004,TEXAS,TX,7359621,"KERRY, JOHN","BUSH, GEORGE W.",2832704,4526917,4526917,2832704,847107,R,34,538,252,286,R,True
401,2004,UTAH,UT,904941,"KERRY, JOHN","BUSH, GEORGE W.",241199,663742,663742,241199,211272,R,5,538,252,286,R,True
402,2004,VERMONT,VT,305247,"KERRY, JOHN","BUSH, GEORGE W.",184067,121180,184067,121180,31444,D,3,538,252,286,R,False
403,2004,VIRGINIA,VA,3171701,"KERRY, JOHN","BUSH, GEORGE W.",1454742,1716959,1716959,1454742,131109,R,13,538,252,286,R,True
404,2004,WASHINGTON,WA,2815095,"KERRY, JOHN","BUSH, GEORGE W.",1510201,1304894,1510201,1304894,102654,D,11,538,252,286,R,False
405,2004,WEST VIRGINIA,WV,750319,"KERRY, JOHN","BUSH, GEORGE W.",326541,423778,423778,326541,48619,R,5,538,252,286,R,True
406,2004,WISCONSIN,WI,2967624,"KERRY, JOHN","BUSH, GEORGE W.",1489504,1478120,1489504,1478120,5693,D,10,538,252,286,R,False
407,2004,WYOMING,WY,238405,"KERRY, JOHN","BUSH, GEORGE W.",70776,167629,167629,70776,48427,R,3,538,252,286,R,True
408,2008,ALABAMA,AL,2080025,"OBAMA, BARACK H.","MCCAIN, JOHN",813479,1266546,1266546,813479,226534,R,9,538,365,173,D,False
409,2008,ALASKA,AK,317435,"OBAMA, BARACK H.","MCCAIN, JOHN",123594,193841,193841,123594,35124,R,3,538,365,173,D,False
410,2008,ARIZONA,AZ,2264818,"OBAMA, BARACK H.","MCCAIN, JOHN",1034707,1230111,1230111,1034707,97703,R,10,538,365,173,D,False
411,2008,ARKANSAS,AR,1060327,"OBAMA, BARACK H.","MCCAIN, JOHN",422310,638017,638017,422310,107854,R,6,538,365,173,D,False
412,2008,CALIFORNIA,CA,13286254,"OBAMA, BARACK H.","MCCAIN, JOHN",8274473,5011781,8274473,5011781,1631347,D,55,538,365,173,D,True
413,2008,COLORADO,CO,2362165,"OBAMA, BARACK H.","MCCAIN, JOHN",1288576,1073589,1288576,1073589,107494,D,9,538,365,173,D,True
414,2008,CONNECTICUT,CT,1627200,"OBAMA, BARACK H.","MCCAIN, JOHN",997772,629428,997772,629428,184173,D,7,538,365,173,D,True
415,2008,DELAWARE,DE,407833,"OBAMA, BARACK H.","MCCAIN, JOHN",255459,152374,255459,152374,51543,D,3,538,365,173,D,True
416,2008,D.C.,DC,263167,"OBAMA, BARACK H.","MCCAIN, JOHN",245800,17367,245800,17367,114217,D,3,538,365,173,D,True
417,2008,FLORIDA,FL,8327698,"OBAMA, BARACK H.","MCCAIN, JOHN",4282074,4045624,4282074,4045624,118226,D,27,538,365,173,D,True
418,2008,GEORGIA,GA,3892882,"OBAMA, BARACK H.","MCCAIN, JOHN",1844123,2048759,2048759,1844123,102319,R,15,538,365,173,D,False
419,2008,HAWAII,HI,446437,"OBAMA, BARACK H.","MCCAIN, JOHN",325871,120566,325871,120566,102653,D,4,538,365,173,D,True
420,2008,IDAHO,ID,639452,"OBAMA, BARACK H.","MCCAIN, JOHN",236440,403012,403012,236440,83287,R,4,538,365,173,D,False
421,2008,ILLINOIS,IL,5450527,"OBAMA, BARACK H.","MCCAIN, JOHN",3419348,2031179,3419348,2031179,694085,D,21,538,365,173,D,True
422,2008,INDIANA,IN,2719687,"OBAMA, BARACK H.","MCCAIN, JOHN",1374039,1345648,1374039,1345648,14196,D,11,538,365,173,D,True
423,2008,IOWA,IA,1511319,"OBAMA, BARACK H.","MCCAIN, JOHN",828940,682379,828940,682379,73281,D,7,538,365,173,D,True
424,2008,KANSAS,KS,1214420,"OBAMA, BARACK H.","MCCAIN, JOHN",514765,699655,699655,514765,92446,R,6,538,365,173,D,False
425,2008,KENTUCKY,KY,1800447,"OBAMA, BARACK H.","MCCAIN, JOHN",751985,1048462,1048462,751985,148239,R,8,538,365,173,D,False
426,2008,LOUISIANA,LA,1931264,"OBAMA, BARACK H.","MCCAIN, JOHN",782989,1148275,1148275,782989,182644,R,9,538,365,173,D,False
427,2008,MAINE,ME,717196,"OBAMA, BARACK H.","MCCAIN, JOHN",421923,295273,421923,295273,63326,D,4,538,365,173,D,True
428,2008,MARYLAND,MD,2589329,"OBAMA, BARACK H.","MCCAIN, JOHN",1629467,959862,1629467,959862,334803,D,10,538,365,173,D,True
429,2008,MASSACHUSETTS,MA,3012951,"OBAMA, BARACK H.","MCCAIN, JOHN",1904097,1108854,1904097,1108854,397622,D,12,538,365,173,D,True
430,2008,MICHIGAN,MI,4921218,"OBAMA, BARACK H.","MCCAIN, JOHN",2872579,2048639,2872579,2048639,411971,D,17,538,365,173,D,True
431,2008,MINNESOTA,MN,2848763,"OBAMA, BARACK H.","MCCAIN, JOHN",1573354,1275409,1573354,1275409,148973,D,10,538,365,173,D,True
432,2008,MISSISSIPPI,MS,1279259,"OBAMA, BARACK H.","MCCAIN, JOHN",554662,724597,724597,554662,84968,R,6,538,365,173,D,False
433,2008,MISSOURI,MO,2887725,"OBAMA, BARACK H.","MCCAIN, JOHN",1441911,1445814,1445814,1441911,1952,R,11,538,365,173,D,False
434,2008,MONTANA,MT,474430,"OBAMA, BARACK H.","MCCAIN, JOHN",231667,242763,242763,231667,5549,R,3,538,365,173,D,False
435,2008,NEBRASKA,NE,511839,"OBAMA, BARACK H.","MCCAIN, JOHN",194427,317412,317412,194427,61493,R,4,538,365,173,D,False
435,2008,NE-02,NE-02,274459,"OBAMA, BARACK H.","MCCAIN, JOHN",138892,135567,138892,135567,1663,D,1,538,365,173,D,True
436,2008,NEVADA,NV,946563,"OBAMA, BARACK H.","MCCAIN, JOHN",533736,412827,533736,412827,60455,D,5,538,365,173,D,True
437,2008,NEW HAMPSHIRE,NH,701360,"OBAMA, BARACK H.","MCCAIN, JOHN",384826,316534,384826,316534,34147,D,4,538,365,173,D,True
438,2008,NEW JERSEY,NJ,3828629,"OBAMA, BARACK H.","MCCAIN, JOHN",2215422,1613207,2215422,1613207,301108,D,15,538,365,173,D,True
439,2008,NEW MEXICO,NM,819254,"OBAMA, BARACK H.","MCCAIN, JOHN",472422,346832,472422,346832,62796,D,5,538,365,173,D,True
440,2008,NEW YORK,NY,7063655,"OBAMA, BARACK H.","MCCAIN, JOHN",4645332,2418323,4645332,2418323,1113505,D,31,538,365,173,D,True
441,2008,NORTH CAROLINA,NC,4271125,"OBAMA, BARACK H.","MCCAIN, JOHN",2142651,2128474,2142651,2128474,7089,D,15,538,365,173,D,True
442,2008,NORTH DAKOTA,ND,309879,"OBAMA, BARACK H.","MCCAIN, JOHN",141278,168601,168601,141278,13662,R,3,538,365,173,D,False
443,2008,OHIO,OH,5617864,"OBAMA, BARACK H.","MCCAIN, JOHN",2940044,2677820,2940044,2677820,131113,D,20,538,365,173,D,True
444,2008,OKLAHOMA,OK,1462661,"OBAMA, BARACK H.","MCCAIN, JOHN",502496,960165,960165,502496,228835,R,7,538,365,173,D,False
445,2008,OREGON,OR,1775766,"OBAMA, BARACK H.","MCCAIN, JOHN",1037291,738475,1037291,738475,149409,D,7,538,365,173,D,True
446,2008,PENNSYLVANIA,PA,5932248,"OBAMA, BARACK H.","MCCAIN, JOHN",3276363,2655885,3276363,2655885,310240,D,21,538,365,173,D,True
447,2008,RHODE ISLAND,RI,461962,"OBAMA, BARACK H.","MCCAIN, JOHN",296571,165391,296571,165391,65591,D,4,538,365,173,D,True
448,2008,SOUTH CAROLINA,SC,1897345,"OBAMA, BARACK H.","MCCAIN, JOHN",862449,1034896,1034896,862449,86224,R,8,538,365,173,D,False
449,2008,SOUTH DAKOTA,SD,373978,"OBAMA, BARACK H.","MCCAIN, JOHN",170924,203054,203054,170924,16066,R,3,538,365,173,D,False
450,2008,TENNESSEE,TN,2566615,"OBAMA, BARACK H.","MCCAIN, JOHN",1087437,1479178,1479178,1087437,195871,R,11,538,365,173,D,False
451,2008,TEXAS,TX,8007961,"OBAMA, BARACK H.","MCCAIN, JOHN",3528633,4479328,4479328,3528633,475348,R,34,538,365,173,D,False
452,2008,UTAH,UT,923700,"OBAMA, BARACK H.","MCCAIN, JOHN",327670,596030,596030,327670,134181,R,5,538,365,173,D,False
453,2008,VERMONT,VT,318236,"OBAMA, BARACK H.","MCCAIN, JOHN",219262,98974,219262,98974,60145,D,3,538,365,173,D,True
454,2008,VIRGINIA,VA,3684537,"OBAMA, BARACK H.","MCCAIN, JOHN",1959532,1725005,1959532,1725005,117264,D,13,538,365,173,D,True
455,2008,WASHINGTON,WA,2980064,"OBAMA, BARACK H.","MCCAIN, JOHN",1750848,1229216,1750848,1229216,260817,D,11,538,365,173,D,True
456,2008,WEST VIRGINIA,WV,701323,"OBAMA, BARACK H.","MCCAIN, JOHN",303857,397466,397466,303857,46805,R,5,538,365,173,D,False
457,2008,WISCONSIN,WI,2939604,"OBAMA, BARACK H.","MCCAIN, JOHN",1677211,1262393,1677211,1262393,207410,D,10,538,365,173,D,True
458,2008,WYOMING,WY,247826,"OBAMA, BARACK H.","MCCAIN, JOHN",82868,164958,164958,82868,41046,R,3,538,365,173,D,False
459,2012,ALABAMA,AL,2051621,"OBAMA, BARACK H.","ROMNEY, MITT",795696,1255925,1255925,795696,230115,R,9,538,332,206,D,False
460,2012,ALASKA,AK,287316,"OBAMA, BARACK H.","ROMNEY, MITT",122640,164676,164676,122640,21019,R,3,538,332,206,D,False
461,2012,ARIZONA,AZ,2258886,"OBAMA, BARACK H.","ROMNEY, MITT",1025232,1233654,1233654,1025232,104212,R,11,538,332,206,D,False
462,2012,ARKANSAS,AR,1042153,"OBAMA, BARACK H.","ROMNEY, MITT",394409,647744,647744,394409,126668,R,6,538,332,206,D,False
463,2012,CALIFORNIA,CA,12694243,"OBAMA, BARACK H.","ROMNEY, MITT",7854285,4839958,7854285,4839958,1507164,D,55,538,332,206,D,True
464,2012,COLORADO,CO,2508344,"OBAMA, BARACK H.","ROMNEY, MITT",1323101,1185243,1323101,1185243,68930,D,9,538,332,206,D,True
465,2012,CONNECTICUT,CT,1539975,"OBAMA, BARACK H.","ROMNEY, MITT",905083,634892,905083,634892,135096,D,7,538,332,206,D,True
466,2012,DELAWARE,DE,408068,"OBAMA, BARACK H.","ROMNEY, MITT",242584,165484,242584,165484,38551,D,3,538,332,206,D,True
467,2012,D.C.,DC,288451,"OBAMA, BARACK H.","ROMNEY, MITT",267070,21381,267070,21381,122845,D,3,538,332,206,D,True
468,2012,FLORIDA,FL,8401203,"OBAMA, BARACK H.","ROMNEY, MITT",4237756,4163447,4237756,4163447,37155,D,29,538,332,206,D,True
469,2012,GEORGIA,GA,3852515,"OBAMA, BARACK H.","ROMNEY, MITT",1773827,2078688,2078688,1773827,152431,R,16,538,332,206,D,False
470,2012,HAWAII,HI,427673,"OBAMA, BARACK H.","ROMNEY, MITT",306658,121015,306658,121015,92822,D,4,538,332,206,D,True
471,2012,IDAHO,ID,633698,"OBAMA, BARACK H.","ROMNEY, MITT",212787,420911,420911,212787,104063,R,4,538,332,206,D,False
472,2012,ILLINOIS,IL,5154728,"OBAMA, BARACK H.","ROMNEY, MITT",3019512,2135216,3019512,2135216,442149,D,20,538,332,206,D,True
473,2012,INDIANA,IN,2573430,"OBAMA, BARACK H.","ROMNEY, MITT",1152887,1420543,1420543,1152887,133829,R,11,538,332,206,D,False
474,2012,IOWA,IA,1553161,"OBAMA, BARACK H.","ROMNEY, MITT",822544,730617,822544,730617,45964,D,6,538,332,206,D,True
475,2012,KANSAS,KS,1133360,"OBAMA, BARACK H.","ROMNEY, MITT",440726,692634,692634,440726,125955,R,6,538,332,206,D,False
476,2012,KENTUCKY,KY,1766560,"OBAMA, BARACK H.","ROMNEY, MITT",679370,1087190,1087190,679370,203911,R,8,538,332,206,D,False
477,2012,LOUISIANA,LA,1961403,"OBAMA, BARACK H.","ROMNEY, MITT",809141,1152262,1152262,809141,171561,R,8,538,332,206,D,False
478,2012,MAINE,ME,693582,"OBAMA, BARACK H.","ROMNEY, MITT",401306,292276,401306,292276,54516,D,4,538,332,206,D,True
479,2012,MARYLAND,MD,2649713,"OBAMA, BARACK H.","ROMNEY, MITT",1677844,971869,1677844,971869,352988,D,10,538,332,206,D,True
480,2012,MASSACHUSETTS,MA,3109604,"OBAMA, BARACK H.","ROMNEY, MITT",1921290,1188314,1921290,1188314,366489,D,11,538,332,206,D,True
481,2012,MICHIGAN,MI,4679825,"OBAMA, BARACK H.","ROMNEY, MITT",2564569,2115256,2564569,2115256,224657,D,16,538,332,206,D,True
482,2012,MINNESOTA,MN,2866392,"OBAMA, BARACK H.","ROMNEY, MITT",1546167,1320225,1546167,1320225,112972,D,10,538,332,206,D,True
483,2012,MISSISSIPPI,MS,1273695,"OBAMA, BARACK H.","ROMNEY, MITT",562949,710746,710746,562949,73899,R,6,538,332,206,D,False
484,2012,MISSOURI,MO,2706236,"OBAMA, BARACK H.","ROMNEY, MITT",1223796,1482440,1482440,1223796,129323,R,10,538,332,206,D,False
485,2012,MONTANA,MT,469767,"OBAMA, BARACK H.","ROMNEY, MITT",201839,267928,267928,201839,33045,R,3,538,332,206,D,False
486,2012,NEBRASKA,NE,777145,"OBAMA, BARACK H.","ROMNEY, MITT",302081,475064,475064,302081,86492,R,5,538,332,206,D,False
487,2012,NEVADA,NV,994940,"OBAMA, BARACK H.","ROMNEY, MITT",531373,463567,531373,463567,33904,D,6,538,332,206,D,True
488,2012,NEW HAMPSHIRE,NH,699479,"OBAMA, BARACK H.","ROMNEY, MITT",369561,329918,369561,329918,19822,D,4,538,332,206,D,True
489,2012,NEW JERSEY,NJ,3600874,"OBAMA, BARACK H.","ROMNEY, MITT",2122786,1478088,2122786,1478088,322350,D,14,538,332,206,D,True
490,2012,NEW MEXICO,NM,751123,"OBAMA, BARACK H.","ROMNEY, MITT",415335,335788,415335,335788,39774,D,5,538,332,206,D,True
491,2012,NEW YORK,NY,6547625,"OBAMA, BARACK H.","ROMNEY, MITT",4324228,2223397,4324228,2223397,1050416,D,29,538,332,206,D,True
492,2012,NORTH CAROLINA,NC,4448786,"OBAMA, BARACK H.","ROMNEY, MITT",2178391,2270395,2270395,2178391,46003,R,15,538,332,206,D,False
493,2012,NORTH DAKOTA,ND,313286,"OBAMA, BARACK H.","ROMNEY, MITT",124966,188320,188320,124966,31678,R,3,538,332,206,D,False
494,2012,OHIO,OH,5489028,"OBAMA, BARACK H.","ROMNEY, MITT",2827621,2661407,2827621,2661407,83108,D,18,538,332,206,D,True
495,2012,OKLAHOMA,OK,1334872,"OBAMA, BARACK H.","ROMNEY, MITT",443547,891325,891325,443547,223890,R,7,538,332,206,D,False
496,2012,OREGON,OR,1724663,"OBAMA, BARACK H.","ROMNEY, MITT",970488,754175,970488,754175,108157,D,7,538,332,206,D,True
497,2012,PENNSYLVANIA,PA,5670708,"OBAMA, BARACK H.","ROMNEY, MITT",2990274,2680434,2990274,2680434,154921,D,20,538,332,206,D,True
498,2012,RHODE ISLAND,RI,436881,"OBAMA, BARACK H.","ROMNEY, MITT",279677,157204,279677,157204,61237,D,4,538,332,206,D,True
499,2012,SOUTH CAROLINA,SC,1937586,"OBAMA, BARACK H.","ROMNEY, MITT",865941,1071645,1071645,865941,102853,R,9,538,332,206,D,False
500,2012,SOUTH DAKOTA,SD,355649,"OBAMA, BARACK H.","ROMNEY, MITT",145039,210610,210610,145039,32786,R,3,538,332,206,D,False
501,2012,TENNESSEE,TN,2423039,"OBAMA, BARACK H.","ROMNEY, MITT",960709,1462330,1462330,960709,250811,R,11,538,332,206,D,False
502,2012,TEXAS,TX,7877967,"OBAMA, BARACK H.","ROMNEY, MITT",3308124,4569843,4569843,3308124,630860,R,38,538,332,206,D,False
503,2012,UTAH,UT,992413,"OBAMA, BARACK H.","ROMNEY, MITT",251813,740600,740600,251813,244394,R,6,538,332,206,D,False
504,2012,VERMONT,VT,291937,"OBAMA, BARACK H.","ROMNEY, MITT",199239,92698,199239,92698,53271,D,3,538,332,206,D,True
505,2012,VIRGINIA,VA,3794342,"OBAMA, BARACK H.","ROMNEY, MITT",1971820,1822522,1971820,1822522,74650,D,13,538,332,206,D,True
506,2012,WASHINGTON,WA,3046066,"OBAMA, BARACK H.","ROMNEY, MITT",1755396,1290670,1755396,1290670,232364,D,12,538,332,206,D,True
507,2012,WEST VIRGINIA,WV,655924,"OBAMA, BARACK H.","ROMNEY, MITT",238269,417655,417655,238269,89694,R,5,538,332,206,D,False
508,2012,WISCONSIN,WI,3031951,"OBAMA, BARACK H.","ROMNEY, MITT",1620985,1410966,1620985,1410966,105010,D,10,538,332,206,D,True
509,2012,WYOMING,WY,240248,"OBAMA, BARACK H.","ROMNEY, MITT",69286,170962,170962,69286,50839,R,3,538,332,206,D,False
510,2016,ALABAMA,AL,2047802,"CLINTON, HILLARY","TRUMP, DONALD J.",729547,1318255,1318255,729547,294355,R,9,538,232,306,R,True
511,2016,ALASKA,AK,279841,"CLINTON, HILLARY","TRUMP, DONALD J.",116454,163387,163387,116454,23467,R,3,538,232,306,R,True
512,2016,ARIZONA,AZ,2413568,"CLINTON, HILLARY","TRUMP, DONALD J.",1161167,1252401,1252401,1161167,45618,R,11,538,232,306,R,True
513,2016,ARKANSAS,AR,1065366,"CLINTON, HILLARY","TRUMP, DONALD J.",380494,684872,684872,380494,152190,R,6,538,232,306,R,True
514,2016,CALIFORNIA,CA,13237598,"CLINTON, HILLARY","TRUMP, DONALD J.",8753788,4483810,8753788,4483810,2134990,D,55,538,232,306,R,False
515,2016,COLORADO,CO,2541354,"CLINTON, HILLARY","TRUMP, DONALD J.",1338870,1202484,1338870,1202484,68194,D,9,538,232,306,R,False
516,2016,CONNECTICUT,CT,1570787,"CLINTON, HILLARY","TRUMP, DONALD J.",897572,673215,897572,673215,112179,D,7,538,232,306,R,False
517,2016,DELAWARE,DE,420730,"CLINTON, HILLARY","TRUMP, DONALD J.",235603,185127,235603,185127,25239,D,3,538,232,306,R,False
518,2016,D.C.,DC,295553,"CLINTON, HILLARY","TRUMP, DONALD J.",282830,12723,282830,12723,135054,D,3,538,232,306,R,False
519,2016,FLORIDA,FL,9122861,"CLINTON, HILLARY","TRUMP, DONALD J.",4504975,4617886,4617886,4504975,56456,R,29,538,232,306,R,True
520,2016,GEORGIA,GA,3967067,"CLINTON, HILLARY","TRUMP, DONALD J.",1877963,2089104,2089104,1877963,105571,R,16,538,232,306,R,True
521,2016,HAWAII,HI,395738,"CLINTON, HILLARY","TRUMP, DONALD J.",266891,128847,266891,128847,69023,D,4,538,232,306,R,False
522,2016,IDAHO,ID,598820,"CLINTON, HILLARY","TRUMP, DONALD J.",189765,409055,409055,189765,109646,R,4,538,232,306,R,True
523,2016,ILLINOIS,IL,5236744,"CLINTON, HILLARY","TRUMP, DONALD J.",3090729,2146015,3090729,2146015,472358,D,20,538,232,306,R,False
524,2016,INDIANA,IN,2590412,"CLINTON, HILLARY","TRUMP, DONALD J.",1033126,1557286,1557286,1033126,262081,R,11,538,232,306,R,True
525,2016,IOWA,IA,1454652,"CLINTON, HILLARY","TRUMP, DONALD J.",653669,800983,800983,653669,73658,R,6,538,232,306,R,True
526,2016,KANSAS,KS,1098023,"CLINTON, HILLARY","TRUMP, DONALD J.",427005,671018,671018,427005,122007,R,6,538,232,306,R,True
527,2016,KENTUCKY,KY,1831825,"CLINTON, HILLARY","TRUMP, DONALD J.",628854,1202971,1202971,628854,287059,R,8,538,232,306,R,True
528,2016,LOUISIANA,LA,1958792,"CLINTON, HILLARY","TRUMP, DONALD J.",780154,1178638,1178638,780154,199243,R,8,538,232,306,R,True
529,2016,MAINE,ME,368711,"CLINTON, HILLARY","TRUMP, DONALD J.",213783,154928,213783,154928,29428,D,3,538,232,306,R,False
529,2016,ME-02,ME-02,324617,"CLINTON, HILLARY","TRUMP, DONALD J.",143952,180665,180665,143952,18357,R,1,538,232,306,R,True
530,2016,MARYLAND,MD,2621097,"CLINTON, HILLARY","TRUMP, DONALD J.",1677928,943169,1677928,943169,367380,D,10,538,232,306,R,False
531,2016,MASSACHUSETTS,MA,3086089,"CLINTON, HILLARY","TRUMP, DONALD J.",1995196,1090893,1995196,1090893,452152,D,11,538,232,306,R,False
532,2016,MICHIGAN,MI,4548382,"CLINTON, HILLARY","TRUMP, DONALD J.",2268839,2279543,2279543,2268839,5353,R,16,538,232,306,R,True
533,2016,MINNESOTA,MN,2690654,"CLINTON, HILLARY","TRUMP, DONALD J.",1367705,1322949,1367705,1322949,22379,D,10,538,232,306,R,False
534,2016,MISSISSIPPI,MS,1185845,"CLINTON, HILLARY","TRUMP, DONALD J.",485131,700714,700714,485131,107792,R,6,538,232,306,R,True
535,2016,MISSOURI,MO,2665579,"CLINTON, HILLARY","TRUMP, DONALD J.",1071068,1594511,1594511,1071068,261722,R,10,538,232,306,R,True
536,2016,MONTANA,MT,456949,"CLINTON, HILLARY","TRUMP, DONALD J.",177709,279240,279240,177709,50766,R,3,538,232,306,R,True
537,2016,NEBRASKA,NE,780455,"CLINTON, HILLARY","TRUMP, DONALD J.",284494,495961,495961,284494,105734,R,5,538,232,306,R,True
538,2016,NEVADA,NV,1051318,"CLINTON, HILLARY","TRUMP, DONALD J.",539260,512058,539260,512058,13602,D,6,538,232,306,R,False
539,2016,NEW HAMPSHIRE,NH,694316,"CLINTON, HILLARY","TRUMP, DONALD J.",348526,345790,348526,345790,1369,D,4,538,232,306,R,False
540,2016,NEW JERSEY,NJ,3750211,"CLINTON, HILLARY","TRUMP, DONALD J.",2148278,1601933,2148278,1601933,273173,D,14,538,232,306,R,False
541,2016,NEW MEXICO,NM,704901,"CLINTON, HILLARY","TRUMP, DONALD J.",385234,319667,385234,319667,32784,D,5,538,232,306,R,False
542,2016,NEW YORK,NY,6906931,"CLINTON, HILLARY","TRUMP, DONALD J.",4379789,2527142,4379789,2527142,926324,D,29,538,232,306,R,False
543,2016,NORTH CAROLINA,NC,4551947,"CLINTON, HILLARY","TRUMP, DONALD J.",2189316,2362631,2362631,2189316,86658,R,15,538,232,306,R,True
544,2016,NORTH DAKOTA,ND,310552,"CLINTON, HILLARY","TRUMP, DONALD J.",93758,216794,216794,93758,61519,R,3,538,232,306,R,True
545,2016,OHIO,OH,5235169,"CLINTON, HILLARY","TRUMP, DONALD J.",2394164,2841005,2841005,2394164,223421,R,18,538,232,306,R,True
546,2016,OKLAHOMA,OK,1369511,"CLINTON, HILLARY","TRUMP, DONALD J.",420375,949136,949136,420375,264381,R,7,538,232,306,R,True
547,2016,OREGON,OR,1784509,"CLINTON, HILLARY","TRUMP, DONALD J.",1002106,782403,1002106,782403,109852,D,7,538,232,306,R,False
548,2016,PENNSYLVANIA,PA,5897174,"CLINTON, HILLARY","TRUMP, DONALD J.",2926441,2970733,2970733,2926441,22147,R,20,538,232,306,R,True
549,2016,RHODE ISLAND,RI,433068,"CLINTON, HILLARY","TRUMP, DONALD J.",252525,180543,252525,180543,35992,D,4,538,232,306,R,False
550,2016,SOUTH CAROLINA,SC,2010762,"CLINTON, HILLARY","TRUMP, DONALD J.",855373,1155389,1155389,855373,150009,R,9,538,232,306,R,True
551,2016,SOUTH DAKOTA,SD,345179,"CLINTON, HILLARY","TRUMP, DONALD J.",117458,227721,227721,117458,55132,R,3,538,232,306,R,True
552,2016,TENNESSEE,TN,2393620,"CLINTON, HILLARY","TRUMP, DONALD J.",870695,1522925,1522925,870695,326116,R,11,538,232,306,R,True
553,2016,TEXAS,TX,8562915,"CLINTON, HILLARY","TRUMP, DONALD J.",3877868,4685047,4685047,3877868,403590,R,38,538,232,306,R,True
554,2016,UTAH,UT,825885,"CLINTON, HILLARY","TRUMP, DONALD J.",310674,515211,515211,310674,102269,R,6,538,232,306,R,True
555,2016,VERMONT,VT,273942,"CLINTON, HILLARY","TRUMP, DONALD J.",178573,95369,178573,95369,41603,D,3,538,232,306,R,False
556,2016,VIRGINIA,VA,3750916,"CLINTON, HILLARY","TRUMP, DONALD J.",1981473,1769443,1981473,1769443,106016,D,13,538,232,306,R,False
557,2016,WASHINGTON,WA,2964465,"CLINTON, HILLARY","TRUMP, DONALD J.",1742718,1221747,1742718,1221747,260486,D,12,538,232,306,R,False
558,2016,WEST VIRGINIA,WV,678165,"CLINTON, HILLARY","TRUMP, DONALD J.",188794,489371,489371,188794,150289,R,5,538,232,306,R,True
559,2016,WISCONSIN,WI,2787820,"CLINTON, HILLARY","TRUMP, DONALD J.",1382536,1405284,1405284,1382536,11375,R,10,538,232,306,R,True
560,2016,WYOMING,WY,230392,"CLINTON, HILLARY","TRUMP, DONALD J.",55973,174419,174419,55973,59224,R,3,538,232,306,R,True
561,2020,ALABAMA,AL,2290794,"BIDEN, JOSEPH R. JR","TRUMP, DONALD J.",849624,1441170,1441170,849624,295774,R,9,538,306,232,D,False
562,2020,ALASKA,AK,343729,"BIDEN, JOSEPH R. JR","TRUMP, DONALD J.",153778,189951,189951,153778,18087,R,3,538,306,232,D,False
563,2020,ARIZONA,AZ,3333829,"BIDEN, JOSEPH R. JR","TRUMP, DONALD J.",1672143,1661686,1672143,1661686,5229,D,11,538,306,232,D,True
564,2020,ARKANSAS,AR,1184579,"BIDEN, JOSEPH R. JR","TRUMP, DONALD J.",423932,760647,760647,423932,168358,R,6,538,306,232,D,False
565,2020,CALIFORNIA,CA,17116679,"BIDEN, JOSEPH R. JR","TRUMP, DONALD J.",11110250,6006429,11110250,6006429,2551911,D,55,538,306,232,D,True
566,2020,COLORADO,CO,3168959,"BIDEN, JOSEPH R. JR","TRUMP, DONALD J.",1804352,1364607,1804352,1364607,219873,D,9,538,306,232,D,True
567,2020,CONNECTICUT,CT,1795548,"BIDEN, JOSEPH R. JR","TRUMP, DONALD J.",1080831,714717,1080831,714717,183058,D,7,538,306,232,D,True
568,2020,DELAWARE,DE,496871,"BIDEN, JOSEPH R. JR","TRUMP, DONALD J.",296268,200603,296268,200603,47833,D,3,538,306,232,D,True
569,2020,D.C.,DC,335909,"BIDEN, JOSEPH R. JR","TRUMP, DONALD J.",317323,18586,317323,18586,149369,D,3,538,306,232,D,True
570,2020,FLORIDA,FL,10965776,"BIDEN, JOSEPH R. JR","TRUMP, DONALD J.",5297045,5668731,5668731,5297045,185844,R,29,538,306,232,D,False
571,2020,GEORGIA,GA,4935487,"BIDEN, JOSEPH R. JR","TRUMP, DONALD J.",2473633,2461854,2473633,2461854,5890,D,16,538,306,232,D,True
572,2020,HAWAII,HI,562994,"BIDEN, JOSEPH R. JR","TRUMP, DONALD J.",366130,196864,366130,196864,84634,D,4,538,306,232,D,True
573,2020,IDAHO,ID,841140,"BIDEN, JOSEPH R. JR","TRUMP, DONALD J.",287021,554119,554119,287021,133550,R,4,538,306,232,D,False
574,2020,ILLINOIS,IL,5918806,"BIDEN, JOSEPH R. JR","TRUMP, DONALD J.",3471915,2446891,3471915,2446891,512513,D,20,538,306,232,D,True
575,2020,INDIANA,IN,2971935,"BIDEN, JOSEPH R. JR","TRUMP, DONALD J.",1242416,1729519,1729519,1242416,243552,R,11,538,306,232,D,False
576,2020,IOWA,IA,1656733,"BIDEN, JOSEPH R. JR","TRUMP, DONALD J.",759061,897672,897672,759061,69306,R,6,538,306,232,D,False
577,2020,KANSAS,KS,1341729,"BIDEN, JOSEPH R. JR","TRUMP, DONALD J.",570323,771406,771406,570323,100542,R,6,538,306,232,D,False
578,2020,KENTUCKY,KY,2099120,"BIDEN, JOSEPH R. JR","TRUMP, DONALD J.",772474,1326646,1326646,772474,277087,R,8,538,306,232,D,False
579,2020,LOUISIANA,LA,2111810,"BIDEN, JOSEPH R. JR","TRUMP, DONALD J.",856034,1255776,1255776,856034,199872,R,8,538,306,232,D,False
580,2020,MAINE,ME,431856,"BIDEN, JOSEPH R. JR","TRUMP, DONALD J.",267890,163966,267890,163966,51963,D,3,538,306,232,D,True
580,2020,ME-02,ME-02,363953,"BIDEN, JOSEPH R. JR","TRUMP, DONALD J.",167182,196771,196771,167182,14795,R,1,538,306,232,D,False
581,2020,MARYLAND,MD,2961437,"BIDEN, JOSEPH R. JR","TRUMP, DONALD J.",1985023,976414,1985023,976414,504305,D,10,538,306,232,D,True
582,2020,MASSACHUSETTS,MA,3549404,"BIDEN, JOSEPH R. JR","TRUMP, DONALD J.",2382202,1167202,2382202,1167202,607501,D,11,538,306,232,D,True
583,2020,MICHIGAN,MI,5453892,"BIDEN, JOSEPH R. JR","TRUMP, DONALD J.",2804040,2649852,2804040,2649852,77095,D,16,538,306,232,D,True
584,2020,MINNESOTA,MN,3201142,"BIDEN, JOSEPH R. JR","TRUMP, DONALD J.",1717077,1484065,1717077,1484065,116507,D,10,538,306,232,D,True
585,2020,MISSISSIPPI,MS,1296162,"BIDEN, JOSEPH R. JR","TRUMP, DONALD J.",539398,756764,756764,539398,108684,R,6,538,306,232,D,False
586,2020,MISSOURI,MO,2971750,"BIDEN, JOSEPH R. JR","TRUMP, DONALD J.",1253014,1718736,1718736,1253014,232862,R,10,538,306,232,D,False
587,2020,MONTANA,MT,588388,"BIDEN, JOSEPH R. JR","TRUMP, DONALD J.",244786,343602,343602,244786,49409,R,3,538,306,232,D,False
588,2020,NEBRASKA,NE,610032,"BIDEN, JOSEPH R. JR","TRUMP, DONALD J.",203066,406966,406966,203066,101951,R,4,538,306,232,D,False
588,2020,NE-02,NE-02,321397,"BIDEN, JOSEPH R. JR","TRUMP, DONALD J.",171517,149880,171517,149880,10819,D,1,538,306,232,D,True
589,2020,NEVADA,NV,1373376,"BIDEN, JOSEPH R. JR","TRUMP, DONALD J.",703486,669890,703486,669890,16799,D,6,538,306,232,D,True
590,2020,NEW HAMPSHIRE,NH,790575,"BIDEN, JOSEPH R. JR","TRUMP, DONALD J.",424921,365654,424921,365654,29634,D,4,538,306,232,D,True
591,2020,NEW JERSEY,NJ,4491609,"BIDEN, JOSEPH R. JR","TRUMP, DONALD J.",2608335,1883274,2608335,1883274,362531,D,14,538,306,232,D,True
592,2020,NEW MEXICO,NM,903508,"BIDEN, JOSEPH R. JR","TRUMP, DONALD J.",501614,401894,501614,401894,49861,D,5,538,306,232,D,True
593,2020,NEW YORK,NY,8475783,"BIDEN, JOSEPH R. JR","TRUMP, DONALD J.",5230985,3244798,5230985,3244798,993094,D,29,538,306,232,D,True
594,2020,NORTH CAROLINA,NC,5443065,"BIDEN, JOSEPH R. JR","TRUMP, DONALD J.",2684292,2758773,2758773,2684292,37241,R,15,538,306,232,D,False
595,2020,NORTH DAKOTA,ND,350497,"BIDEN, JOSEPH R. JR","TRUMP, DONALD J.",114902,235595,235595,114902,60347,R,3,538,306,232,D,False
596,2020,OHIO,OH,5833999,"BIDEN, JOSEPH R. JR","TRUMP, DONALD J.",2679165,3154834,3154834,2679165,237835,R,18,538,306,232,D,False
597,2020,OKLAHOMA,OK,1524170,"BIDEN, JOSEPH R. JR","TRUMP, DONALD J.",503890,1020280,1020280,503890,258196,R,7,538,306,232,D,False
598,2020,OREGON,OR,2298831,"BIDEN, JOSEPH R. JR","TRUMP, DONALD J.",1340383,958448,1340383,958448,190968,D,7,538,306,232,D,True
599,2020,PENNSYLVANIA,PA,6835903,"BIDEN, JOSEPH R. JR","TRUMP, DONALD J.",3458229,3377674,3458229,3377674,40278,D,20,538,306,232,D,True
600,2020,RHODE ISLAND,RI,507408,"BIDEN, JOSEPH R. JR","TRUMP, DONALD J.",307486,199922,307486,199922,53783,D,4,538,306,232,D,True
601,2020,SOUTH CAROLINA,SC,2476644,"BIDEN, JOSEPH R. JR","TRUMP, DONALD J.",1091541,1385103,1385103,1091541,146782,R,9,538,306,232,D,False
602,2020,SOUTH DAKOTA,SD,411514,"BIDEN, JOSEPH R. JR","TRUMP, DONALD J.",150471,261043,261043,150471,55287,R,3,538,306,232,D,False
603,2020,TENNESSEE,TN,2996186,"BIDEN, JOSEPH R. JR","TRUMP, DONALD J.",1143711,1852475,1852475,1143711,354383,R,11,538,306,232,D,False
604,2020,TEXAS,TX,11149473,"BIDEN, JOSEPH R. JR","TRUMP, DONALD J.",5259126,5890347,5890347,5259126,315611,R,38,538,306,232,D,False
605,2020,UTAH,UT,1425422,"BIDEN, JOSEPH R. JR","TRUMP, DONALD J.",560282,865140,865140,560282,152430,R,6,538,306,232,D,False
606,2020,VERMONT,VT,355524,"BIDEN, JOSEPH R. JR","TRUMP, DONALD J.",242820,112704,242820,112704,65059,D,3,538,306,232,D,True
607,2020,VIRGINIA,VA,4375998,"BIDEN, JOSEPH R. JR","TRUMP, DONALD J.",2413568,1962430,2413568,1962430,225570,D,13,538,306,232,D,True
608,2020,WASHINGTON,WA,3954263,"BIDEN, JOSEPH R. JR","TRUMP, DONALD J.",2369612,1584651,2369612,1584651,392481,D,12,538,306,232,D,True
609,2020,WEST VIRGINIA,WV,781366,"BIDEN, JOSEPH R. JR","TRUMP, DONALD J.",235984,545382,545382,235984,154700,R,5,538,306,232,D,False
610,2020,WISCONSIN,WI,3241050,"BIDEN, JOSEPH R. JR","TRUMP, DONALD J.",1630866,1610184,1630866,1610184,10342,D,10,538,306,232,D,True
611,2020,WYOMING,WY,267050,"BIDEN, JOSEPH R. JR","TRUMP, DONALD J.",73491,193559,193559,73491,60035,R,3,538,306,232,D,False
561,2024,ALABAMA,AL,2227095,"HARRIS, KAMALA D.","TRUMP, DONALD J.",769391,1457704,1457704,769391,344157,R,9,538,226,312,R,True
562,2024,ALASKA,AK,324016,"HARRIS, KAMALA D.","TRUMP, DONALD J.",139812,184204,184204,139812,22197,R,3,538,226,312,R,True
563,2024,ARIZONA,AZ,3353102,"HARRIS, KAMALA D.","TRUMP, DONALD J.",1582860,1770242,1770242,1582860,93692,R,11,538,226,312,R,True
564,2024,ARKANSAS,AR,1156146,"HARRIS, KAMALA D.","TRUMP, DONALD J.",396905,759241,759241,396905,181169,R,6,538,226,312,R,True
565,2024,CALIFORNIA,CA,15172623,"HARRIS, KAMALA D.","TRUMP, DONALD J.",9183800,5988823,9183800,5988823,1597489,D,54,538,226,312,R,False
566,2024,COLORADO,CO,3104681,"HARRIS, KAMALA D.","TRUMP, DONALD J.",1727603,1377078,1727603,1377078,175263,D,10,538,226,312,R,False
567,2024,CONNECTICUT,CT,1733966,"HARRIS, KAMALA D.","TRUMP, DONALD J.",994494,739472,994494,739472,127512,D,7,538,226,312,R,False
568,2024,DELAWARE,DE,504109,"HARRIS, KAMALA D.","TRUMP, DONALD J.",289758,214351,289758,214351,37704,D,3,538,226,312,R,False
569,2024,D.C.,DC,310118,"HARRIS, KAMALA D.","TRUMP, DONALD J.",289244,20874,289244,20874,134186,D,3,538,226,312,R,False
570,2024,FLORIDA,FL,10793163,"HARRIS, KAMALA D.","TRUMP, DONALD J.",4683038,6110125,6110125,4683038,713544,R,30,538,226,312,R,True
571,2024,GEORGIA,GA,5211134,"HARRIS, KAMALA D.","TRUMP, DONALD J.",2548017,2663117,2663117,2548017,57551,R,16,538,226,312,R,True
572,2024,HAWAII,HI,505553,"HARRIS, KAMALA D.","TRUMP, DONALD J.",312384,193169,312384,193169,59608,D,4,538,226,312,R,False
573,2024,IDAHO,ID,880100,"HARRIS, KAMALA D.","TRUMP, DONALD J.",274956,605144,605144,274956,165095,R,4,538,226,312,R,True
574,2024,ILLINOIS,IL,5500718,"HARRIS, KAMALA D.","TRUMP, DONALD J.",3056201,2444517,3056201,2444517,305843,D,19,538,226,312,R,False
575,2024,INDIANA,IN,2891281,"HARRIS, KAMALA D.","TRUMP, DONALD J.",1163657,1727624,1727624,1163657,281984,R,11,538,226,312,R,True
576,2024,IOWA,IA,1634290,"HARRIS, KAMALA D.","TRUMP, DONALD J.",706556,927734,927734,706556,110590,R,6,538,226,312,R,True
577,2024,KANSAS,KS,1273453,"HARRIS, KAMALA D.","TRUMP, DONALD J.",531989,741464,741464,531989,104738,R,6,538,226,312,R,True
578,2024,KENTUCKY,KY,2039568,"HARRIS, KAMALA D.","TRUMP, DONALD J.",701407,1338161,1338161,701407,318378,R,8,538,226,312,R,True
579,2024,LOUISIANA,LA,1975375,"HARRIS, KAMALA D.","TRUMP, DONALD J.",766870,1208505,1208505,766870,220818,R,8,538,226,312,R,True
580,2024,MAINE,ME,421892,"HARRIS, KAMALA D.","TRUMP, DONALD J.",256570,165322,256570,165322,45625,D,3,538,226,312,R,False
580,2024,ME-02,ME-02,383875,"HARRIS, KAMALA D.","TRUMP, DONALD J.",174225,209650,209650,174225,17713,R,1,538,226,312,R,True
581,2024,MARYLAND,MD,2887467,"HARRIS, KAMALA D.","TRUMP, DONALD J.",1860918,1026549,1860918,1026549,417185,D,10,538,226,312,R,False
582,2024,MASSACHUSETTS,MA,3307532,"HARRIS, KAMALA D.","TRUMP, DONALD J.",2072571,1234961,2072571,1234961,418806,D,11,538,226,312,R,False
583,2024,MICHIGAN,MI,5553169,"HARRIS, KAMALA D.","TRUMP, DONALD J.",2736533,2816636,2816636,2736533,40052,R,15,538,226,312,R,True
584,2024,MINNESOTA,MN,3176011,"HARRIS, KAMALA D.","TRUMP, DONALD J.",1656979,1519032,1656979,1519032,68974,D,10,538,226,312,R,False
585,2024,MISSISSIPPI,MS,1211662,"HARRIS, KAMALA D.","TRUMP, DONALD J.",465357,746305,746305,465357,140475,R,6,538,226,312,R,True
586,2024,MISSOURI,MO,2929870,"HARRIS, KAMALA D.","TRUMP, DONALD J.",1190823,1739047,1739047,1190823,274113,R,10,538,226,312,R,True
587,2024,MONTANA,MT,583857,"HARRIS, KAMALA D.","TRUMP, DONALD J.",231856,352001,352001,231856,60073,R,4,538,226,312,R,True
588,2024,NEBRASKA,NE,608770,"HARRIS, KAMALA D.","TRUMP, DONALD J.",199002,409768,409768,199002,105384,R,4,538,226,312,R,True
588,2024,NE-02,NE-02,311919,"HARRIS, KAMALA D.","TRUMP, DONALD J.",163298,148621,163298,148621,7339,D,1,538,226,312,R,False
589,2024,NEVADA,NV,1456402,"HARRIS, KAMALA D.","TRUMP, DONALD J.",705197,751205,751205,705197,23005,R,6,538,226,312,R,True
590,2024,NEW HAMPSHIRE,NH,814027,"HARRIS, KAMALA D.","TRUMP, DONALD J.",418496,395531,418496,395531,11483,D,4,538,226,312,R,False
591,2024,NEW JERSEY,NJ,4184649,"HARRIS, KAMALA D.","TRUMP, DONALD J.",2218078,1966571,2218078,1966571,125754,D,14,538,226,312,R,False
592,2024,NEW MEXICO,NM,902054,"HARRIS, KAMALA D.","TRUMP, DONALD J.",478727,423327,478727,423327,27701,D,5,538,226,312,R,False
593,2024,NEW YORK,NY,7882893,"HARRIS, KAMALA D.","TRUMP, DONALD J.",4404111,3478782,4404111,3478782,462665,D,28,538,226,312,R,False
594,2024,NORTH CAROLINA,NC,5613808,"HARRIS, KAMALA D.","TRUMP, DONALD J.",2715380,2898428,2898428,2715380,91525,R,16,538,226,312,R,True
595,2024,NORTH DAKOTA,ND,358832,"HARRIS, KAMALA D.","TRUMP, DONALD J.",112327,246505,246505,112327,67090,R,3,538,226,312,R,True
596,2024,OHIO,OH,5592582,"HARRIS, KAMALA D.","TRUMP, DONALD J.",2476003,3116579,3116579,2476003,320289,R,17,538,226,312,R,True
597,2024,OKLAHOMA,OK,1535812,"HARRIS, KAMALA D.","TRUMP, DONALD J.",499599,1036213,1036213,499599,268308,R,7,538,226,312,R,True
598,2024,OREGON,OR,2136567,"HARRIS, KAMALA D.","TRUMP, DONALD J.",1226991,909576,1226991,909576,158708,D,8,538,226,312,R,False
599,2024,PENNSYLVANIA,PA,6963593,"HARRIS, KAMALA D.","TRUMP, DONALD J.",3421088,3542505,3542505,3421088,60709,R,19,538,226,312,R,True
600,2024,RHODE ISLAND,RI,499562,"HARRIS, KAMALA D.","TRUMP, DONALD J.",285156,214406,285156,214406,35376,D,4,538,226,312,R,False
601,2024,SOUTH CAROLINA,SC,2512199,"HARRIS, KAMALA D.","TRUMP, DONALD J.",1028452,1483747,1483747,1028452,227648,R,9,538,226,312,R,True
602,2024,SOUTH DAKOTA,SD,418940,"HARRIS, KAMALA D.","TRUMP, DONALD J.",146859,272081,272081,146859,62612,R,3,538,226,312,R,True
603,2024,TENNESSEE,TN,3019538,"HARRIS, KAMALA D.","TRUMP, DONALD J.",1055039,1964499,1964499,1055039,454731,R,11,538,226,312,R,True
604,2024,TEXAS,TX,11181850,"HARRIS, KAMALA D.","TRUMP, DONALD J.",4806474,6375376,6375376,4806474,784452,R,40,538,226,312,R,True
605,2024,UTAH,UT,1446359,"HARRIS, KAMALA D.","TRUMP, DONALD J.",562560,883799,883799,562560,160620,R,6,538,226,312,R,True
606,2024,VERMONT,VT,361630,"HARRIS, KAMALA D.","TRUMP, DONALD J.",242235,119395,242235,119395,61421,D,3,538,226,312,R,False
607,2024,VIRGINIA,VA,4410428,"HARRIS, KAMALA D.","TRUMP, DONALD J.",2335367,2075061,2335367,2075061,130154,D,13,538,226,312,R,False
608,2024,WASHINGTON,WA,3767936,"HARRIS, KAMALA D.","TRUMP, DONALD J.",2241465,1526471,2241465,1526471,357498,D,12,538,226,312,R,False
609,2024,WEST VIRGINIA,WV,747865,"HARRIS, KAMALA D.","TRUMP, DONALD J.",214309,533556,533556,214309,159624,R,4,538,226,312,R,True
610,2024,WISCONSIN,WI,3365855,"HARRIS, KAMALA D.","TRUMP, DONALD J.",1668229,1697626,1697626,1668229,14699,R,10,538,226,312,R,True
611,2024,WYOMING,WY,262160,"HARRIS, KAMALA D.","TRUMP, DONALD J.",69527,192633,192633,69527,61554,R,3,538,226,312,R,True
